border_size=1
usage=map

Xos, Xos, Xos, Xos, Xos, Xos, Xos, Xos, Xos, Xos, Xos, Xos, Xos, Xos, Xos, Xos, Xos, Xos, Xos, Xos, Xos, Xos, Xos, Xos, Xos, Xos, Xos, Xos, Xos, Xos, Xos, Xos, Xos, Xos, Xos, Xos, Xos, Xos, Xos, Xos, Xos, Xos, Xos, Xos, Xos, Xos, Xos, Xos, Xos, Xos, Xos, Xos, Xos, Xos, Xos, Xos, Xos, Xos, Xos, Xos, Xos, Xos, Xos, Xos, Xos, Xos, Xos, Xos, Xos, Xos
Xos, Xos, Xos, Xos, Xos, Xos, Xos, Xos, Xos, Xos, Xos, Xos, Xos, Xos, Xos, Xos, Xos, Xos, Xos, Xos, Xos, Xos, Xos, Xos, Xos, Xos, Xos, Xos, Urfz^Uyod, Xos, Xos, Xos, Xos, Xos, Xos, Xos, Xos, Xos, Xos, Xos, Xos, Xos, Xos, Xos, Xos, Xos, Xos, Xos, Xos, Xos, Xos, Xos, Xos, Xos, Xos, Xos, Xos, Xos, Xos, Xos, Xos, Xos, Xos, Xos, Xos, Xos, Xos, Xos, Xos, Xos
Xos, Xos, Xos, Xos, Xos, Xos, Xos, Xos, Xos, Xos, Xos, Xos, Xos, Xos, Xos, Xos, Xos, Xos, Xos, Xos, Xos, Xos, Xos, Xos, Xos, Xos, Urfz^Bryl, Xos, Urb, Xos, Urfz^Bryl, Xos, Xos, Xos, Xos, Xos, Xos, Xos, Xos, Xos, Xos, Xos, Xos, Xos, Xos, Xos, Xos, Xos, Xos, Xos, Xos, Xos, Xos, Xos, Xos, Xos, Xos, Xos, Xos, Xos, Xos, Xos, Xos, Xos, Xos, Xos, Xos, Xos, Xos, Xos
Xos, Xos, Xos, Xos, Xos, Xos, Xos, Xos, Xos, Xos, Xos, Xos, Xos, Xos, Xos, Xos, Xos, Xos, Xos, Xos, Xos, Xos, Xos, Xos, Xos, Urfz, Urfz^Es, Urb, Urb, Urb, Urfz, Xos, Xos, Xos, Xos, Xos, Xos, Xos, Xos, Xos, Xos, Xos, Xos, Xos, Xos, Xos, Xos, Xos, Xos, Xos, Xos, Xos, Xos, Xos, Xos, Xos, Xos, Xos, Xos, Xos, Xos, Xos, Urfz^Uyod, Xos, Xos, Xos, Xos, Xos, Xos, Xos
Xos, Xos, Xos, Xos, Xos, Xos, Xos, Xos, Xos, Xos, Xos, Xos, Xos, Xos, Xos, Xos, Xos, Xos, Xos, Xos, Xos, Xos, Xos, Xos, Xos, Urfz, Urfz, Urfz, Urfz, Urfz, Urfz, Urfz, Urfz, Xos, Xos, Xos, Xos, Xos, Xos, Xos, Xos, Xos, Xos, Xos, Xos, Xos, Xos, Xos, Xos, Xos, Xos, Xos, Xos, Xos, Xos, Xos, Xos, Xos, Xos, Xos, Xos, Xos, Urb, Xos, Xos, Xos, Xos, Xos, Xos, Xos
Xos, Xos, Xos, Xos, Xos, Xos, Xos, Xos, Xos, Xos, Xos, Xos, Xos, Xos, Xos, Xos, Xos, Xos, Xos, Xos, Xos, Xos, Xos, Xos, Xos, Xos, Xos, Urfz, Urfz, Urfz, Urfz, Urfz, Urfz, Urfz, Urfz^Gtye, Xos, Urb^Bryl, Xos, Xos, Xos, Xos, Xos, Xos, Xos, Xos, Xos, Xos, Xos, Xos, Xos, Xos, Xos, Xos, Xos, Xos, Xos, Xos, Xos, Xos, Xos, Uu^Dr, Urb, Urb, Urb, Xos, Xos, Xos, Xos, Xos, Xos
Xos, Xos, Xos, Xos, Xos, Xos, Xos, Xos, Xos, Xos, Xos, Xos, Xos, Xos, Xos, Xos, Xos, Xos, Xos, Xos, Xos, Xos, Xos, Xos, Xos, Xos, Urfz, Xos, Xos, Urfz, Urfz, Urfz, Xos, Xos, Xos, Urb, Urb, Xos, Xos, Xos, Xos, Xos, Xos, Xos, Xos, Xos, Xos, Xos, Xos, Xos, Xos, Xos, Xos, Xos, Xos, Xos, Xos, Xos, Xos, Xos, Uu, Urb, Urb, Urb, Xos, Xos, Xos, Xos, Xos, Xos
Xos, Xos, Xos, Xos, Xos, Xos, Xos, Xos, Xos, Xos, Xos, Xos, Xos, Xos, Xos, Xos, Xos, Xos, Xos, Xos, Xos, Xos, Xos, Xos, Urfz, Urfz, Urfz, Urfz, Urfz, Xos, Xos, Urfz^Gtye, Urfz, Xos, Xos, Xos, Urb, Xos, Xos, Xos, Xos, Xos, Xos, Xos, Xos, Xos, Xos, Xos, Xos, Xos, Xos, Xos, Xos, Xos, Xos, Xos, Xos, Xos, Xos, Xos, Dsmz, Urb, Urb, Uu, Xos, Xos, Xos, Xos, Xos, Xos
Xos, Xos, Xos, Xos, Xos, Xos, Xos, Xos, Xos, Xos, Xos, Xos, Xos, Xos, Xos, Xos, Xos, Xos, Xos, Xos, Xos, Xos, Urfz, Urfz, Urfz, Urfz, Urfz^Es, Urfz, Urfz, Urfz, Urfz, Urfz, Urfz, Xos, Xos, Xos, Urb, Xos, Xos, Xos, Xos, Xos, Urfz^Uyod, Xos, Xos, Xos, Xos, Xos, Xos, Xos, Xos, Xos, Xos, Xos, Xos, Xos, Xos, Xos, Dsmz, Uu, Urb, Urb, Urb, Dsmz, Xos, Xos, Xos, Xos, Xos, Xos
Xos, Xos, Xos, Xos, Xos, Xos, Xos, Xos, Xos, Xos, Xos, Xos, Xos, Xos, Xos, Xos, Xos, Xos, Xos, Xos, Xos, Xos, Xos, Urfz, Urfz, Urfz, Urfz, Urfz, Urfz, Urfz, Urfz, Urfz, Urfz, Xos, Xos, Xos, Urb, Xos, Xos, Xos, Xos, Xos, Urb, Xos, Urb^Bryl, Xos, Xos, Xos, Xos, Xos, Xos, Xos, Xos, Xos, Xos, Xos, Uu, Dsmz, Urb, Urb, Urb, Urb, Urb, Dsmz, Xos, Xos, Xos, Xos, Xos, Xos
Xos, Xos, Xos, Xos, Xos, Xos, Xos, Xos, Xos, Xos, Xos, Xos, Xos, Xos, Xos, Xos, Xos, Xos, Xos, Xos, Xos, Xos, Xos, Xos, Xos, Urfz, Urfz, Urfz, Xos, Xos, Xos, Urfz, Xos, Xos, Xos, Xos, Urb, Xos, Xos, Xos, Urb, Urb, Urb, Urb, Urb, Xos, Xos, Xos, Xos, Xos, Xos, Xos, Urb, Xos, Urb, Uu, Urb, Urb, Urb, Urb^Es, Uu^Es, Urb, Urb, Dsmz^Dr, Xos, Xos, Xos, Xos, Xos, Xos
Xos, Xos, Xos, Xos, Xos, Xos, Xos, Xos, Xos, Xos, Xos, Xos, Xos, Xos, Xos, Xos, Urfz^Uyod, Xos, Xos, Xos, Xos, Xos, Xos, Xos, Xos, Xos, Xos, Xos, Xos, Xos, Xos, Xos, Xos, Xos, Xos, Xos, Urb, Urb, Urb, Xos, Xos, Urb, Urb, Urb, Urb, Xos, Xos, Xos, Xos, Xos, Fyp^Gsyw, Urb, Urb, Urb^Dr, Urb, Urb, Urb, Urb, Dsmz, Uu^Es, Dsmz, Urb, Xos, Xos, Xos, Xos, Xos, Xos, Xos, Xos
Xos, Xos, Xos, Xos, Xos, Xos, Xos, Xos, Xos, Xos, Xos, Xos, Xos, Xos, Xos, Xos, Urb, Xos, Urfz^Bryl, Xos, Xos, Xos, Xos, Xos, Xos, Xos, Uu, Xos, Uu, Xos, Uu, Xos, Uu^Tbny, Xos, Xos, Xos, Xos, Urb, Urb, Urb, Urb, Urb, Urb, Urb, Xos, Xos, Xos, Xos, Xos, Xos, Fyp, Urb, Urb, Urb, Dsmz, Dsmz, Uu, Dsmz, Xos, Dsmz, Xos, Xos, Xos, Xos, Xos, Xos, Xos, Xos, Xos, Xos
Xos, Xos, Xos, Xos, Xos, Xos, Xos, Xos, Xos, Xos, Xos, Xos, Xos, Xos, Urfz, Urfz, Urfz, Urfz, Urfz, Xos, Xos, Xos, Xos, Xos, Xos, Uu^Tbny, Uu, Uu, Uu, Uu, Uu, Uu, Uu^Tbny, Xos, Xos, Xos, Xos, Xos, Xos, Urb, Urb, Urb, Xos, Xos, Xos, Xos, Xos, Xos, Xos, Xos, Fyp, Fyp, Fyp, Uu, Xos, Uu, Xos, Xos, Xos, Xos, Xos, Xos, Xos, Xos, Xos, Xos, Xos, Xos, Xos, Xos
Xos, Xos, Xos, Xos, Xos, Xos, Xos, Xos, Xos, Xos, Xos, Xos, Xos, Urfz, Urfz^Es, Urfz, Urfz, Urfz, Urfz, Xos, Xos, Xos, Xos, Xos, Xos, Uu^Tbny, Uu, Uu, Uu, Uu, Uu, Uu, Uu^Tbny, Xos, Xos, Xos, Xos, Xos, Xos, Xos, Xos, Xos, Xos, Xos, Xos, Xos, Xos, Xos, Xos, Xos, Fyp, Fyp, Fyp, Xos, Xos, Xos, Xos, Xos, Xos, Xos, Xos, Xos, Xos, Xos, Xos, Xos, Xos, Xos, Xos, Xos
Xos, Xos, Xos, Xos, Xos, Xos, Xos, Xos, Xos, Xos, Xos, Xos, Xos, Urfz^Es, Urfz^Es, Urfz, Urfz^Es, Urfz, Urfz, Xos, Xos, Uu^Tbny, Uu^Tbny, Uu^Tbny, Xos, Uu^Tbny, Uu, Uu, Tmmy, Uu, Uu, Uu, Uu^Tbny, Uu^Tbny, Uu^Tbny, Uu^Fyok, Uu^Tbny, Uu^Tbny, Uu, Xos, Xos, Xos, Xos, Xos, Xos, Xos, Xos, Xos, Xos, Xos, Fyp, Fyp, Fyp, Xos, Xos, Xos, Xos, Xos, Xos, Xos, Xos, Xos, Xos, Xos, Xos, Xos, Xos, Xos, Xos, Xos
Xos, Xos, Xos, Xos, Xos, Xos, Xos, Xos, Xos, Xos, Xos, Xos, Xos, Urfz, Urfz, Urfz, Urfz, Urfz, Urfz, Xos, Xos, Uu^Tbny, Uu^Tbny, Uu^Tbny, Uu^Tbny, Uu^Tbny, Uu, Uu^Tbny, Uu^Tbny, Uu, Uu, Uu^Tbny, Uu^Tbny, Uu^Tbny, Uu^Tbny, Uu^Tbny, Uu^Tbny, Uu^Tbny, Uu^Tbny, Xos, Xos, Xos, Xos, Xos, Xos, Xos, Xos, Xos, Xos, Xos, Fyp, Fyp, Fyp, Xos, Xos, Xos, Xos, Xos, Xos, Xos, Xos, Xos, Xos, Xos, Xos, Xos, Xos, Xos, Xos, Xos
Xos, Xos, Xos, Xos, Xos, Xos, Xos, Xos, Xos, Xos, Xos, Xos, Xos, Xos, Xos, Urfz, Urfz, Urfz, Xos, Xos, Xos^Tbny, Uu^Tbny, Uu^Tbny, Uu^Tbny, Uu^Tbny, Uu^Tbny, Uu^Tbny, Uu^Tbny, Uu^Tbny, Uu, Uu^Tbny, Uu^Tbny, Uu^Tbny, Uu^Tbny, Uu^Tbny, Uu^Tbny, Uu^Tbny, Uu^Tbny, Uu^Tbny, Xos, Xos, Xos, Xos, Xos, Xos, Xos, Xos, Xos, Xos, Xos, Fyp, Fyp, Fyp, Xos, Xos, Xos, Xos, Xos, Xos, Xos, Xos, Xos, Xos, Xos, Xos, Xos, Xos, Xos, Xos, Xos
Xos, Xos, Xos, Xos, Xos, Xos, Xos, Xos, Xos, Xos, Xos, Xos, Xos, Xos, Xos, Urfz, Urfz, Urfz, Xos, Xos, Xos, Uu^Tbny, Uu^Tbny, Ur^Fyok, Uu^Tbny, Uu, Uu, Uu, Uu, Uu, Uu, Uu, Uu, Uu, Uu^Tbny, Uu, Uu^Tbny, Uu, Uu^Tbny, Xos, Xos, Xos, Xos, Xos, Xos, Xos, Xos, Xos, Xos, Xos, Fyp, Fyp, Fyp, Xos, Xos, Xos, Xos, Xos, Xos, Xos, Xos, Xos, Xos, Xos, Xos, Xos, Xos, Xos, Xos, Xos
Xos, Xos, Xos, Xos, Xos, Xos, Xos, Xos, Xos, Xos, Xos, Xos, Xos, Xos, Urfz^Dr, Urfz, Urfz, Urfz, Xos, Xos, Xos, Uu, Ur^Tbny, Ur, Ur, Rd, Dd^Bryl, Rd, Uu, Rb^Lyr|, Urb, Rd, Dd^Bryl, Uu, Uu, Uh, Uu, Uu, Uu, Xos, Xos, Xos, Xos, Xos, Xos, Xos, Xos, Xos, Fyp, Fyp, Fyp, Fyp, Fyp, Fyp, Fyp, Xos, Xos, Xos, Xos, Xos, Xos, Xos, Xos, Xos, Xos, Xos, Xos, Xos, Xos, Xos
Xos, Xos, Xos, Xos, Xos, Xos, Xos, Xos, Xos, Xos, Xos, Xos, Xos, Xos, Urfz^Dr, Urfz^Es, Urfz^Es, Urfz, Xos, Xos, Xos, Uu, Uu, Uu, Uu, Rd^Es, Rd, Rd, Rb^Lyl|, Rb^Lyr|, Rd, Rd, Rd, Uu^Es, Uu, Uu, Uu, Uu, Uu, Xos, Xos, Xos, Xos, Xos, Xos, Xos, Fyp^Gsyw, Fyp, Fyp, Fyp, Xos, Xos, Fyp, Fyp, Fyp, Fyp, Fyp, Xos, Xos, Xos, Xos, Xos, Xos, Xos, Xos, Xos, Xos, Xos, Xos, Xos
Xos, Xos, Xos, Xos, Xos, Xos, Xos, Xos, Xos, Xos, Xos, Xos, Xos, Xos, Urfz, Urfz^Es, Urfz, Urfz, Xos, Xos, Xos, Uu, Uu, Ur^Ecf, Uu, Uu, Rd, Rd, Rb^Lyl|, Rb^Lyr\, Rd, Rd, Rd, Uu, Uu^Ecf, Uu, Ur, Uu, Uu, Xos, Xos, Xos, Xos, Xos, Xos, Urb, Urb, Fyp^Gsyw, Xos, Xos, Fyp, Fyp, Fyp, Fyp, Fyp, Fyp, Xos, Xos, Xos, Xos, Xos, Xos, Xos, Xos, Xos, Xos, Xos, Xos, Xos, Xos
Xos, Xos, Xos, Xos, Xos, Xos, Xos, Xos, Xos, Xos, Xos, Xos, Xos, Xos, Xos, Urfz, Urfz, Urfz, Xos, Xos, Xos, Uu, Uu, Ur, Uu, Uu, Rd, Rd, Rb^Lyl|, Rb, Rb^Lyr\, Rd, Rd, Rd, Uu, Ur, Ur, Ur, Uu, Xos, Xos, Xos, Xos, Xos, Xos, Urb, Urb, Urb, Xos, Fyp, Fyp, Fyp, Fyp, Fyp, Xos, Xos, Xos, Xos, Xos, Xos, Xos, Xos, Xos, Xos, Xos, Xos, Xos, Xos, Xos, Xos
Xos, Xos, Xos, Xos, Xos, Xos, Xos, Xos, Xos, Xos, Xos, Xos, Xos, Xos, Xos, Urfz, Urfz, Urfz, Xos, Xos, Xos, Ur, Ur, Ur, Uu, Uu, Rd, Rd, Rb^Lyl|, Rp, Rb^Lyr|, Urb, Urb, Urb, Urb, Urb, Ur, Urb, Urb, Xos, Xos, Xos, Xos, Xos, Xos, Urb, Urb, Urb, Xos, Xos, Xos, Fyp, Xos, Xos, Xos, Xos, Xos, Xos, Xos, Xos, Xos, Xos, Xos, Xos, Xos, Xos, Xos, Xos, Xos, Xos
Xos, Xos, Xos, Xos, Xos, Xos, Xos, Xos, Xos, Xos, Xos, Xos, Xos, Xos, Xos, Urfz, Urfz, Urfz, Xos, Xos, Xos, Ur, Ur, Ur, Ur, Urb, Urb, Urb, Rp^Lyl|, Rr, Rp^Lyr|, Urb, Urb, Urb, Urb, Urb, Urb, Urb, Urb, Xos, Xos, Xos, Xos, Xos, Xos, Urb, Urb, Urb, Xos, Xos, Xos, Xos, Xos, Xos, Xos, Xos, Xos, Xos, Xos, Xos, Xos, Xos, Xos, Xos, Xos, Xos, Xos, Xos, Xos, Xos
Xos, Xos, Xos, Xos, Xos, Xos, Xos, Xos, Xos, Xos, Xos, Xos, Xos, Xos, Xos, Urfz, Urfz, Urfz, Xos, Xos, Xos, Urb, Urb, Urb, Urb, Urb, Urb, Urb, Rr^Lyl|, Rrc, Rr^Lyr|, Urb, Urb, Urb, Urb, Urb, Urb, Urb, Urb, Xos, Xos, Xos, Xos, Xos, Xos, Urb, Urb, Urb, Xos, Xos, Xos, Xos, Xos, Xos, Xos, Xos, Xos, Xos, Xos, Xos, Xos, Xos, Xos, Xos, Xos, Xos, Xos, Xos, Xos, Xos
Xos, Xos, Xos, Xos, Xos, Xos, Xos, Xos, Xos, Xos, Xos, Xos, Xos, Xos, Xos, Urfz, Urfz, Urfz, Xos, Xos, Xos, Urb, Urb, Urb, Urb, Urb, Urb, Urb, Rrc^Lyl|, Rrc, Rrc^Lyr|, Urb, Urb, Urb, Urb, Urb, Urb, Urb, Urb, Xos, Xos, Xos, Xos, Xos, Urb, Urb, Urb, Urb, Xos, Xos, Xos, Xos, Xos, Xos, Xos, Xos, Xos, Xos, Xos, Xos, Xos, Xos, Xos, Xos, Xos, Xos, Xos, Xos, Xos, Xos
Xos, Xos, Xos, Xos, Xos, Xos, Xos, Xos, Xos, Xos, Xos, Xos, Xos, Xos, Xos, Urfz^Es, Urfz, Urfz, Xos, Xos, Xos, Urb, Urb, Urb^Vud, Urb, Urb, Urb, Urb, Rrc^Lyl|, Rrc, Rrc^Lyr|, Urb, Urb, Urb, Urb, Urb^Vud, Urb, Urb, Urb, Xos, Xos, Xos, Xos, Xos, Urb, Urb, Urb, Urb, Xos, Xos, Xos, Xos, Xos, Xos, Xos, Xos, Xos, Xos, Xos, Xos, Xos, Xos, Xos, Xos, Xos, Xos, Xos, Xos, Xos, Xos
Xos, Xos, Xos, Xos, Xos, Xos, Xos, Xos, Xos, Xos, Xos, Xos, Xos, Xos, Xos, Urfz, Urfz, Urfz, Urfz, Xos, Xos, Urb, Urb, Urb, Urb, Urb, Urb, Urb, Rrc^Lyl|, Rrc, Rrc^Lyr|, Urb, Urb, Urb, Urb, Urb, Urb, Urb, Urb, Xos, Xos, Xos, Xos, Xos, Urb^Es, Urb^Dr, Urb, Urb, Xos, Xos, Xos, Xos, Xos, Xos, Xos, Xos, Xos, Xos, Xos, Xos, Xos, Xos, Xos, Xos, Xos, Xos, Xos, Xos, Xos, Xos
Xos, Xos, Xos, Xos, Xos, Xos, Xos, Xos, Xos, Xos, Xos, Xos, Xos, Xos, Xos, Xos, Urfz, Urfz, Urfz^Gtye, Urfz^Gtye, Urb, Urb, Urb, Urb, Urb, Urb, Urb, Urb, Rrc^Lyl|, Rrc, Rrc^Lyr|, Urb, Urb, Urb, Urb, Urb, Urb, Urb, Urb, Xos, Xos, Xos, Urb, Urb^Es, Urb^Es, Urb^Es, Urb, Urb, Xos, Xos, Xos, Xos, Xos, Xos, Xos, Xos, Xos, Xos, Xos, Xos, Xos, Xos, Xos, Xos, Xos, Xos, Xos, Xos, Xos, Xos
Xos, Xos, Xos, Xos, Xos, Xos, Xos, Xos, Xos, Xos, Xos, Xos, Xos, Xos, Xos, Xos, Xos, Urfz^Gtye, Urb, Urb, Urb, Urb, Urb, Urb, Urb, Urb, Urb, Urb, Ur^Lyl|, Rrc, Ur^Lyr|, Urb, Urb, Urb, Urb, Urb, Xos, Xos, Xos, Xos, Urb, Urb, Urb, Urb, Urb, Urb, Urb, Urb^Dr, Xos, Xos, Xos, Xos, Xos, Xos, Xos, Xos, Xos, Xos, Xos, Xos, Xos, Xos, Xos, Xos, Xos, Xos, Xos, Xos, Xos, Xos
Xos, Xos, Xos, Xos, Xos, Xos, Xos, Xos, Rrc^Bryl, Xos, Rrc, Xos, Xos, Xos, Xos, Xos, Xos, Xos, Xos, Urb, Urb, Urb^Dr, Urb, Urb, Urb, Urb, Urb, Urb, Ur^Lyl|, Ur, Ur^Lyr|, Urb, Xos, Xos, Xos, Xos, Urb, Urb^Dr, Urb, Urb, Urb, Urb, Urb, Urb, Urb, Urb, Xos, Xos, Xos, Xos, Xos, Xos, Xos, Xos, Xos, Xos, Xos, Xos, Xos, Xos, Xos, Xos, Xos, Xos, Xos, Xos, Xos, Xos, Xos, Xos
Xos, Xos, Xos, Xos, Xos, Xos, Xos, Xos, Rrc, Rrc, Rrc, Rrc, Rrc, Xos, Xos, Xos, Xos, Xos, Xos, Xos, Urb, Urb, Urb, Urb, Urb, Urb, Urb, Urb, Ur^Lyl\, Ur, Ur, Xos, Xos, Urb^Bryl, Urb, Urb, Urb, Urb, Urb, Urb, Urb, Urb, Xos, Urb, Xos, Xos, Xos, Xos, Xos, Xos, Xos, Xos, Xos, Xos, Xos, Xos, Xos, Xos, Xos, Xos, Xos, Xos, Xos, Xos, Xos, Xos, Xos, Xos, Xos, Xos
Xos, Xos, Xos, Xos, Xos, Xos, Xos, Rrc, Rrc, Rrc, Rrc, Rrc, Rrc, Rrc, Xos, Xos, Xos, Xos, Xos, Xos, Xos, Urb, Xos, Urb, Xos, Urb, Xos, Xos, Xos, Ur, Ur^Gtye, Ur^Gtye, Ur^Es, Urb, Urb^Dr, Urb, Urb, Urb, Urb, Urb, Xos, Xos, Qxu, Xos, Qxu, Qxu^Chyp, Qxu^Chyp, Qxu^Chyp, Qxu^Chyp, Xos, Xos, Xos, Xos, Xos, Xos, Xos, Xos, Xos, Qxu, Xos, Xos, Xos, Xos, Xos, Xos, Xos, Xos, Xos, Xos, Xos
Xos, Xos, Xos, Xos, Xos, Xos, Xos, Xos, Urb, Rrc, Rrc, Rrc, Urb, Xos, Xos, Xos, Xos, Xos, Xos, Xos, Xos, Xos, Xos, Xos, Xos, Xos, Urb, Urb, Urb, Xos, Urb, Ur, Ur, Urb, Urb, Ur, Urb, Urb, Urb, Xos, Qxu, Qxu, Qxu^Chyp, Qxu, Qxu^Chyp, Qxu, Qxu, Qxu^Chyp, Qxu^Chyp, Qxu^Chyp, Qxu, Qxu^Chyp, Qxu^Chyp, Qxu^Chyp, Qxu^Chyp, Qxu^Chyp, Qxu^Chyp, Qxu, Qxu, Qxu, Xos, Xos, Xos, Xos, Xos, Xos, Xos, Xos, Xos, Xos
Xos, Xos, Rrc^Bryu, Xos, Rrc, Xos, Urb, Urb, Xos, Xos, Xos, Xos, Xos, Urb, Urb, Xos, Xos, Xos, Urb, Xos, Xos, Xos, Xos, Xos, Xos, Urb, Urb^Es, Urb, Urb, Urb, Urb, Ur^Lyl|, Ur^Es, Ur, Urb, Urb, Urb, Urb, Xos, Xos, Qxu, Qxu^Chyp, Qxu, Qxu^Chyp, Qxu, Qxu^Chyp, Qxu, Qxu^Chyp, Qxu^Chyp, Qxu^Chyp, Qxu^Chyp, Qxu^Chyp, Qxu, Qxu^Chyp, Qxu, Qxu^Chyp, Qxu^Chyp, Qxu, Qxu, Qxu, Qxu, Xos, Xos, Xos, Xos, Xos, Xos, Xos, Xos, Xos
Xos, Xos, Rrc, Rrc, Rrc, Rrc, Rrc, Xos, Xos, Xos, Xos, Xos, Xos, Urb, Urb, Xos, Urb, Urb, Xos, Urb, Urb, Xos, Urb, Xos, Xos, Urb, Urb^Es, Urb^Es, Urb, Urb, Urb, Urb, Urb, Urb, Urb^Dr, Urb, Urb, Urb, Xos, Xos, Qxu, Qxu, Qxu, Qxu, Qxu^Chyp, Qxu, Qxu, Qxu, Qxu, Qxu^Chyp, Qxu, Qxu^Chyp, Qxu, Qxu, Qxu, Qxu, Qxu, Qxu, Qxu, Qxu, Qxu, Xos, Xos, Xos, Xos, Xos, Xos, Xos, Xos, Xos
Xos, Rrc, Rrc, Rrc, Rrc, Rrc, Rrc, Rrc, Xos, Xos, Xos, Xos, Xos, Xos, Xos, Urb, Xos, Xos, Xos, Xos, Urb, Urb, Urb, Urb, Urb, Xos, Xos, Urb, Urb, Urb, Urb^Dr, Urb^Dr, Urb^Dr, Xos, Xos, Urb, Xos, Urb, Xos, Qxu, Qxu, Qxu, Qxu, Qxu, Qxu, Qxu, Qxu, Qxu, Qxu, Qxu, Qxu, Qxu, Qxu, Qxu, Qxu, Qxu, Qxu, Qxu, Qxu, Qxu, Qxu, Qxu, Xos, Xos, Xos, Xos, Xos, Xos, Xos, Xos
Xos, Xos, Rrc, Rrc, Rrc, Rrc, Urb, Xos, Xos, Xos, Xos, Xos, Xos, Xos, Xos, Xos, Xos, Xos, Xos, Xos, Xos, Urb, Urb, Urb, Urb, Urb, Urb, Urb^Gtyw, Urb^Gtyw, Urb, Urb, Urb, Xos, Xos, Fyp, Xos, Xos, Xos, Qxu, Qxu, Qxu, Qxu, Qxu, Qxu, Qxu, Qxu, Qxu, Qxu, Qxu, Qxu, Qxu, Qxu, Qxu, Qxu, Qxu, Qxu, Qxu, Qxu, Qxu, Qxu, Qxu, Qxu, Xos, Xos, Xos, Xos, Xos, Xos, Xos, Xos
Xos, Xos, Xos, Rrc, Xos, Xos, Xos, Urb, Urb, Xos, Xos, Xos, Xos, Xos, Xos, Xos, Xos, Xos, Xos, Xos, Xos, Xos, Urb, Urb, Urb, Urb, Urb, Urb, Urb, Xos, Xos, Xos, Urb, Fyp, Qxu^Pyg, Fyp, Xos, Xos, Qxu, Qxu, Qxu, Qxu, Qxu, Qxu, Qxu, Qxu, Qxu, Qxu, Qxu, Qxu, Qxu, Qxu, Qxu, Qxu, Qxu, Qxu, Qxu, Qxu, Qxu, Qxu, Qxu, Qxu, Qxu, Xos, Xos, Xos, Xos, Xos, Xos, Xos
Xos, Xos, Xos, Xos, Xos, Xos, Xos, Xos, Xos, Urb, Urb, Xos, Xos, Xos, Rrc, Xos, Rrc^Bryl, Xos, Xos, Xos, Xos, Xos, Urb, Urb, Urb, Urb, Xos, Urb, Xos, Xos, Urb, Fyp, Fyp, Fyp, Qxu^Pyg, Qxu^Pyg, Xos, Fypd, Qxu, Qxu, Qxu, Qxu, Qxu, Qxu, Qxu, Qxu, Qxu, Qxu, Qxu, Qxu, Qxu, Qxu, Qxu, Qxu, Qxu, Qxu, Qxu, Qxu, Qxu, Qxu, Qxu, Qxu, Qxu, Xos, Xos, Xos, Xos, Xos, Xos, Xos
Xos, Xos, Xos, Xos, Xos, Xos, Xos, Xos, Xos, Xos, Xos, Urb, Rrc, Rrc, Rrc, Rrc, Rrc, Xos, Xos, Xos, Xos, Xos, Xos, Urb, Xos, Xos, Xos, Xos, Urb, Urb, Urb, Urb, Fyp, Qxu^Pyg, Qxu^Pyg, Xos, Fyp^Gsyw, Fypd, Fypd, Fypd, Fypd, Qxu, Qxu, Qxu, Qxu, Qxu, Qxu, Qxu, Qxu, Qxu, Qxu, Qxu, Qxu, Qxu, Qxu, Qxu, Qxu, Qxu, Qxu, Qxu, Qxu, Qxu, Qxu, Xos, Xos, Xos, Xos, Xos, Xos, Xos
Xos, Xos, Xos, Xos, Xos, Xos, Xos, Xos, Xos, Xos, Rrc, Rrc, Rrc, Rrc, Rrc, Rrc, Rrc, Rrc, Xos, Xos, Xos, Xos, Xos, Xos, Xos, Xos, Urb, Urb, Urb^Dr, Urb, Urb, Urb^Es, Urb, Fyp, Fyp, Fyp, Fyp, Xos, Xos, Fypd, Fypd, Qxu, Qxu^Chyn, Qxu, Qxu, Qxu, Qxu, Qxu, Qxu, Qxu, Qxu, Qxu, Qxu, Qxu, Qxu, Qxu, Qxu, Qxu, Qxu, Qxu, Qxu, Qxu, Qxu, Xos, Xos, Xos, Xos, Xos, Xos, Xos
Xos, Xos, Xos, Xos, Xos, Xos, Xos, Xos, Xos, Xos, Xos, Rrc, Rrc, Rrc, Rrc, Rrc, Xos, Xos, Xos, Xos, Xos, Xos, Xos, Xos, Xos, Xos, Urb, Urb, Urb, Urb, Urb, Urb, Fyp, Fyp, Qxu^Pyg, Fyp, Fyp, Fyp, Xos, Xos, Fypd, Fypd, Qxu, Qxu, Qxu, Qxu, Qxu^Iryn, Qxu, Qxu, Qxu, Qxu, Qxu, Qxu, Qxu, Qxu, Qxu, Qxu, Qxu, Qxu, Qxu, Qxu, Qxu, Xos, Xos, Xos, Xos, Xos, Xos, Xos, Xos
Xos, Xos, Xos, Xos, Rrc^Bryl, Xos, Rrc, Rrc, Rrc, Xos, Urb, Rrc, Xos, Rrc, Xos, Xos, Xos, Xos, Xos, Xos, Xos, Xos, Xos, Xos, Xos, Xos, Xos, Urb, Urb, Urb, Urb, Urb, Fyp, Fyp, Qxu^Pyg, Qxu^Pyg, Fyp, Fyp, Fyp, Fyp^Gsyw, Xos, Fypd, Qxu, Qxu, Qxu, Qxu, Qxu, Qxu, Qxu, Qxu, Qxu, Qxu, Qxu, Qxu, Qxu, Qxu, Qxu, Qxu, Qxu, Qxu, Xos, Xos, Xos, Xos, Xos, Xos, Xos, Xos, Xos, Xos
Xos, Xos, Xos, Xos, Rrc, Rrc, Rrc, Rrc, Rrc, Rrc, Rrc, Xos, Xos, Xos, Xos, Xos, Xos, Xos, Xos, Xos, Xos, Xos, Xos, Xos, Xos, Xos, Xos, Urb, Urb, Urb^Es, Urb^Es, Urb^Es, Fyp, Fyp, Fyp, Qxu^Pyg, Qxu^Pyg, Fyp, Qxu^Pyg, Xos, Xos, Fypd, Qxu, Qxu, Qxu^Chyn, Qxu, Qxu, Qxu, Qxu, Qxu, Qxu, Qxu^Iryn, Qxu, Qxu, Qxu, Qxu, Qxu, Qxu, Xos, Xos, Xos, Xos, Xos, Xos, Xos, Xos, Xos, Xos, Xos, Xos
Xos, Xos, Xos, Rrc, Rrc, Rrc, Rrc^Macy, Rrc, Rrc, Rrc, Rrc, Rrc, Rrc, Xos, Xos, Xos, Xos, Xos, Xos, Xos, Xos, Xos, Xos, Xos, Xos, Xos, Xos, Xos, Urb, Urb, Urb, Urb, Fyp, Fyp, Fyp, Qxu^Pyg, Qxu^Pyg, Qxu^Pyg, Qxu^Pyg, Xos, Xos, Qxu, Qxu, Qxu, Qxu, Qxu, Qxu, Qxu, Qxu, Qxu, Qxu, Qxu, Qxu, Qxu, Qxu, Qxu, Xos, Xos, Xos, Xos, Xos, Xos, Xos, Xos, Xos, Xos, Xos, Xos, Xos, Xos
Xos, Xos, Xos, Xos, Xos, Rrc, Rrc, Rrc, Rrc, Rrc, Rrc, Rrc, Xos, Xos, Xos, Xos, Xos, Xos, Xos, Xos, Xos, Xos, Xos, Xos, Xos, Xos, Xos, Xos, Xos, Urb, Urb, Fyp, Fyp, Urb, Fyp, Fyp, Qxu^Pyg, Qxu^Pyg, Qxu^Pyg, Xos, Xos, Qxu, Qxu, Qxu, Qxu, Qxu, Qxu, Qxu, Qxu, Qxu, Qxu, Qxu, Qxu, Qxu, Xos, Xos, Xos, Xos, Xos, Xos, Xos, Xos, Xos, Xos, Xos, Xos, Xos, Xos, Xos, Xos
Xos, Xos, Xos, Xos, Xos, Xos, Xos, Rrc, Rrc, Rrc, Xos, Xos, Xos, Xos, Xos, Xos, Xos, Xos, Xos, Xos, Xos, Xos, Xos, Xos, Xos, Xos, Urfz, Xos, Xos, Xos, Urb, Urb, Urb, Fyp, Fyp, Fyp, Qxu^Pyg, Qxu^Pyg, Qxu^Pyg, Xos, Fypd, Qxu, Qxu, Qxu, Qxu, Qxu, Qxu, Qxu, Qxu, Qxu, Qxu, Qxu, Xos, Xos, Xos, Xos, Xos, Xos, Xos, Xos, Xos, Xos, Xos, Xos, Xos, Xos, Xos, Xos, Xos, Xos
Xos, Xos, Xos, Xos, Xos, Xos, Xos, Xos, Xos, Xos, Xos, Xos, Xos, Xos, Xos, Xos, Urfz^Uyod, Xos, Xos, Xos, Xos, Xos, Xos, Xos, Urfz^Dr, Urfz, Urfz^Es, Urfz, Urfz, Xos, Urb, Urb, Urb, Urb, Fyp, Qxu^Pyg, Qxu^Pyg, Qxu^Pyg, Xos, Xos, Fypd, Fypd, Fypd, Qxu, Xos, Qxu, Xos, Qxu, Qxu, Qxu, Qxu, Qxu, Xos, Xos, Xos, Xos, Xos, Xos, Xos, Xos, Xos, Xos, Xos, Xos, Xos, Xos, Xos, Xos, Xos, Xos
Xos, Xos, Xos, Xos, Xos, Xos, Xos, Xos, Xos, Xos, Xos, Xos, Xos, Xos, Xos, Xos, Urb, Xos, Urfz, Urfz, Urfz, Urfz^Bryl, Urfz, Urfz, Urfz, Urfz, Urfz, Urfz, Xos, Xos, Urb^Vud, Urb, Urb, Urb, Fyp, Qxu^Pyg, Qxu^Pyg, Fyp, Fyp, Fyp^Gsyw, Fyp^Gsyw, Fypd, Fypd, Xos, Xos, Xos, Xos, Qxu, Qxu, Xos, Xos, Xos, Xos, Xos, Xos, Xos, Xos, Xos, Xos, Xos, Xos, Xos, Xos, Xos, Xos, Xos, Xos, Xos, Xos, Xos
Xos, Xos, Xos, Xos, Xos, Xos, Xos, Xos, Xos, Xos, Urb, Xos, Xos, Xos, Xos, Urb, Urb, Urb, Urfz, Urfz, Urfz, Urfz, Urfz^Es, Urfz, Urfz, Urfz, Urfz, Urfz, Urfz, Urb, Urb, Urb, Urb, Urb, Fyp, Qxu^Pyg, Qxu^Pyg, Fyp, Fyp^Fyod, Fyp, Xos, Xos, Xos, Xos, Xos, Xos, Xos, Xos, Xos, Xos, Xos, Xos, Xos, Xos, Xos, Xos, Xos, Xos, Xos, Xos, Xos, Xos, Xos, Xos, Xos, Xos, Xos, Xos, Xos, Xos
Xos, Xos, Xos, Xos, Xos, Xos, Xos, Xos, Urb, Urb, Urb, Urb, Urb, Xos, Xos, Xos, Urfz, Urfz, Urfz, Urfz, Urfz, Urfz, Urfz, Urfz, Xos, Xos, Urfz, Urfz, Urfz, Urfz, Urfz, Urb, Urb, Urb, Fyp, Fyp, Qxu^Pyg, Qxu^Pyg, Qxu^Pyg, Fyp, Qxu^Pyg, Xos, Xos, Xos, Xos, Xos, Xos, Xos, Xos, Xos, Xos, Xos, Xos, Xos, Urb, Urb, Urb, Xos, Xos, Xos, Xos, Xos, Xos, Xos, Xos, Xos, Xos, Xos, Xos, Xos
Xos, Xos, Xos, Xos, Xos, Xos, Urb, Urb, Xos, Xos, Xos, Urb, Urb, Urb, Urb, Urfz^Gyw, Urfz^Gyw, Urfz, Urfz, Urfz^Es, Urfz, Urfz, Urfz, Urfz, Xos, Urb, Urb^Vud, Urfz, Urfz, Urfz, Urfz, Urfz, Urfz, Urb, Fyp, Fyp, Qxu^Pyg, Qxu^Pyg, Qxu^Pyg, Qxu^Pyg, Qxu^Pyg, Qxu^Pyg, Fyp, Xos, Xos, Xos, Xos, Xos, Urb, Xos, Xos, Xos, Xos, Xos, Urb, Urb^Bryu, Urb, Xos, Xos, Xos, Xos, Xos, Xos, Xos, Xos, Xos, Xos, Xos, Xos, Xos
Xos, Xos, Xos, Xos, Urb^Tshy, Urb, Urb^Tshy, Urb, Urb, Xos, Urb, Urb, Urb, Urb, Urb, Urb, Xos, Xos, Xos, Urfz, Xos, Urfz, Xos, Xos, Xos, Urb, Urb, Urb, Urb, Urfz, Urfz, Urfz, Urfz, Urfz, Urfz, Fyp, Fyp, Fyp, Qxu^Pyg, Qxu^Pyg, Qxu^Pyg, Qxu^Pyg, Fyp, Urb, Urb, Xos, Urb, Urb, Xos, Urb, Urb, Xos, Urb, Urb, Xos, Urb, Xos, Xos, Xos, Xos, Xos, Xos, Xos, Xos, Xos, Xos, Xos, Xos, Xos, Xos
Xos, Xos, Xos, Urb^Tshy, Urb^Tshy, Urb^Tshy, Urb^Tshy, Urb^Tshy, Urb^Tshy, Urb^Tshy, Urb^Tshy, Urb, Urb, Urb, Urb, Urb, Xos, Xos, Xu, Xos, Xos, Xos, Xos, Xos, Xos, Urb, Xos, Xos, Xos, Urb, Urb, Urb^Es, Urb, Urfz, Urfz, Urfz, Urb, Fyp, Fyp, Qxu^Pyg, Fyp, Fyp, Urb, Urb, Urb^Fyod, Urb, Xos, Xos, Xos, Xos, Xos, Urb, Xos, Xos, Xos, Xos, Xos, Xos, Xos, Xos, Xos, Xos, Xos, Xos, Xos, Xos, Xos, Xos, Xos, Xos
Xos, Xos, Xos, Xos, Xos, Urb^Tshy, Urb^Tshy, Urb^Tshy, Urb^Tshy, Urb^Tshy, Urb^Tshy, Urb^Tshy, Urb^Tshy, Urb, Xu, Xos, Xu, Xu, Xu, Xu, Xu, Xos, Xos, Xos, Xu, Xos, Uue^Dr, Uue^Dr, Uue^Es, Xos, Xos, Urb, Urb, Urfz, Urfz, Urfz, Urb, Urb, Urb, Fyp, Urb, Urb, Urb^Es, Urb, Urb, Urb, Xos, Xos, Xos, Xos, Xos, Xos, Xos, Xos, Xos, Xos, Xos, Xos, Xos, Xos, Xos, Xos, Xos, Xos, Xos, Xos, Xos, Xos, Xos, Xos
Xos, Xos, Xos, Xos, Xos, Xos, Xos, Urb^Tshy, Urb^Tshy, Urb^Tshy, Urb^Tshy, Urb^Tshy, Xos, Xos, Xu, Uu, Uu, Uu, Ur, Xu, Xu, Xu, Xu, Xu, Dd, Dd^Dr, Uue, Uue, Uue^Es, Rd^Es, Rd, Xos, Urb, Urb^Es, Urfz^Es, Urfz, Urb, Urb, Urb, Urb, Urb, Urb, Urb, Urb, Urb, Urb, Xos, Xos, Xos, Xos, Xos, Xos, Xos, Xos, Xos, Xos, Xos, Xos, Xos, Xos, Xos, Xos, Xos, Xos, Xos, Xos, Xos, Xos, Xos, Xos
Xos, Xos, Xos, Xos, Xos, Xos, Xos, Xos, Xos, Urb^Tshy, Xos, Xos, Xos, Xos, Xos, Xu, Xu, Ur, Xu, Ur, Rd, Dd, Rd, Rd, Dd, Dd, Rd, Rd, Uue, Uue^Es, Dd^Es, Xos, Urb, Urb, Urb, Urfz, Urb, Urb^Dr, Urb, Urb, Urb, Urb, Urb, Urb, Xos, Xos, Xos, Xos, Xos, Xos, Xos, Xos, Xos, Xos, Xos, Xos, Xos, Xos, Xos, Xos, Xos, Xos, Xos, Xos, Xos, Xos, Xos, Xos, Xos, Xos
Xos, Xos, Xos, Xos, Xos, Xos, Xos, Xos, Xos, Xos, Xos, Xos, Xos, Xos, Xos, Xos, Xos, Xu, Xos, Xu, Xu, Rd, Xu, Dd, Dd, Dd^Dr, Rd, Rd, Dd^Es, Dd^Es, Rd, Xos, Urb, Urb, Urb, Urb, Urb, Urb, Urb, Urb, Xos, Urb, Xos, Xos, Xos, Xos, Xos, Xos, Xos, Xos, Xos, Xos, Xos, Xos, Xos, Xos, Xos, Xos, Xos, Xos, Xos, Xos, Xos, Xos, Xos, Xos, Xos, Xos, Xos, Xos
Xos, Xos, Xos, Xos, Xos, Xos, Xos, Xos, Xos, Xos, Xos, Xos, Xos, Xos, Xos, Xos, Xos, Xos, Xos, Xos, Xos, Xu, Xu, Dd, Dd, Rd, Rd, Dd, Dd, Dd^Es, Rd, Xos, Urb, Urb, Urb, Urb, Urb, Urb, Xos, Xos, Xos, Xos, Xos, Xos, Xos, Xos, Xos, Xos, Xos, Xos, Xos, Xos, Xos, Xos, Xos, Xos, Xos, Xos, Xos, Xos, Xos, Xos, Xos, Xos, Xos, Xos, Xos, Xos, Xos, Xos
Xos, Xos, Xos, Xos, Xos, Xos, Xos, Xos, Xos, Xos, Xos, Xos, Xos, Xos, Xos, Xos, Xos, Xos, Xos, Xos, Xos, Xos, Xu, Dd, Dd, Dd, Dd^Dr, Dd, Rd, Rd, Xu, Xos, Urb, Urb, Xos, Urb, Xos, Xos, Xos, Xos, Xos, Xos, Xos, Xos, Xos, Xos, Xos, Xos, Xos, Xos, Xos, Xos, Xos, Xos, Xos, Xos, Xos, Xos, Xos, Xos, Xos, Xos, Xos, Xos, Xos, Xos, Xos, Xos, Xos, Xos
Xos, Xos, Xos, Xos, Xos, Xos, Xos, Xos, Xos, Xos, Xos, Xos, Xos, Xos, Xos, Xos, Xos, Xos, Xos, Xos, Xos, Xos, Xos, Xu, Xu, Dd, Dd, Dd, Rd, Rd, Xu, Xos, Xos, Xos, Xos, Xos, Xos, Xos, Xos, Xos, Xos, Xos, Xos, Xos, Xos, Xos, Xos, Xos, Xos, Xos, Xos, Xos, Xos, Xos, Xos, Xos, Xos, Xos, Xos, Xos, Xos, Xos, Xos, Xos, Xos, Xos, Xos, Xos, Xos, Xos
Xos, Xos, Xos, Xos, Xos, Xos, Xos, Xos, Xos, Xos, Xos, Xos, Xos, Xos, Xos, Xos, Xos, Xos, Xos, Xos, Xos, Xos, Xos, Xos, Xos, Xu, Xu, Rd, Xu, Xu, Xu, Xos, Xos, Xos, Xos, Xos, Xos, Xos, Xos, Xos, Xos, Xos, Xos, Xos, Xos, Xos, Xos, Xos, Xos, Xos, Xos, Xos, Xos, Xos, Xos, Xos, Xos, Xos, Xos, Xos, Xos, Xos, Xos, Xos, Xos, Xos, Xos, Xos, Xos, Xos
Xos, Xos, Xos, Xos, Xos, Xos, Xos, Xos, Xos, Xos, Xos, Xos, Xos, Xos, Xos, Xos, Xos, Xos, Xos, Xos, Xos, Xos, Xos, Xos, Xos, Xos, Xos, Xu, Xos, Xos, Xos, Xos, Xos, Xos, Xos, Xos, Xos, Xos, Xos, Xos, Xos, Xos, Xos, Xos, Xos, Xos, Xos, Xos, Xos, Xos, Xos, Xos, Xos, Xos, Xos, Xos, Xos, Xos, Xos, Xos, Xos, Xos, Xos, Xos, Xos, Xos, Xos, Xos, Xos, Xos
Xos, Xos, Xos, Xos, Xos, Xos, Xos, Xos, Xos, Xos, Xos, Xos, Xos, Xos, Xos, Xos, Xos, Xos, Xos, Xos, Xos, Xos, Xos, Xos, Xos, Xos, Xos, Xos, Xos, Xos, Xos, Xos, Xos, Xos, Xos, Xos, Xos, Xos, Xos, Xos, Xos, Xos, Xos, Xos, Xos, Xos, Xos, Xos, Xos, Xos, Xos, Xos, Xos, Xos, Xos, Xos, Xos, Xos, Xos, Xos, Xos, Xos, Xos, Xos, Xos, Xos, Xos, Xos, Xos, Xos
Xos, Xos, Xos, Xos, Xos, Xos, Xos, Xos, Xos, Xos, Xos, Xos, Xos, Xos, Xos, Xos, Xos, Xos, Xos, Xos, Xos, Xos, Xos, Xos, Xos, Xos, Xos, Xos, Xos, Xos, Xos, Xos, Xos, Xos, Xos, Xos, Xos, Xos, Xos, Xos, Xos, Xos, Xos, Xos, Xos, Xos, Xos, Xos, Xos, Xos, Xos, Xos, Xos, Xos, Xos, Xos, Xos, Xos, Xos, Xos, Xos, Xos, Xos, Xos, Xos, Xos, Xos, Xos, Xos, Xos
Xos, Xos, Xos, Xos, Xos, Xos, Xos, Xos, Xos, Xos, Xos, Xos, Xos, Xos, Xos, Xos, Xos, Xos, Xos, Xos, Xos, Xos, Xos, Xos, Xos, Xos, Xos, Xos, Xos, Xos, Xos, Xos, Xos, Xos, Xos, Xos, Xos, Xos, Xos, Xos, Xos, Xos, Xos, Xos, Xos, Xos, Xos, Xos, Xos, Xos, Xos, Xos, Xos, Xos, Xos, Xos, Xos, Xos, Xos, Xos, Xos, Xos, Xos, Xos, Xos, Xos, Xos, Xos, Xos, Xos
Xos, Xos, Xos, Xos, Xos, Xos, Xos, Xos, Xos, Xos, Xos, Xos, Xos, Xos, Xos, Xos, Xos, Xos, Xos, Xos, Xos, Xos, Xos, Xos, Xos, Xos, Xos, Xos, Xos, Xos, Xos, Xos, Xos, Xos, Xos, Xos, Xos, Xos, Xos, Xos, Xos, Xos, Xos, Xos, Xos, Xos, Xos, Xos, Xos, Xos, Xos, Xos, Xos, Xos, Xos, Xos, Xos, Xos, Xos, Xos, Xos, Xos, Xos, Xos, Xos, Xos, Xos, Xos, Xos, Xos
Xos, Xos, Xos, Xos, Xos, Xos, Xos, Xos, Xos, Xos, Xos, Xos, Xos, Xos, Xos, Xos, Xos, Xos, Xos, Xos, Xos, Xos, Xos, Xos, Xos, Xos, Xos, Xos, Xos, Xos, Xos, Xos, Xos, Xos, Xos, Xos, Xos, Xos, Xos, Xos, Xos, Xos, Xos, Xos, Xos, Xos, Xos, Xos, Xos, Xos, Xos, Xos, Xos, Xos, Xos, Xos, Xos, Xos, Xos, Xos, Xos, Xos, Xos, Xos, Xos, Xos, Xos, Xos, Xos, Xos
