border_size=1
usage=map

Dd, Dd, Dd, Gd, Gd, Gd, Gd, Gs, Wwg, Wwg, Wwg, Gs, Gd, Gd, Gd, Rd, Gd, Ce, Gd, Gs
Dd, Dd, Dd, Dd, Dd, Dd, Dd, Gs, Wwg, Wwg, Wwg, Gs, Gd, Gd, Gd, Rd, Gd, Gd, Gd^Vhr, Gs
Gd, Dd, Dd, Gd, Dd, Dd, Dd, Gs, Wwg, Wwg, Wwg, Wwf, Gd, Gd, Rd, Rd, Gd, Gd, Gd, Gd
Dd, Dd, Dd, Dd, Dd, Dd, Rd, Gs, Wwg, Wwg, Wwg, Gs, Dd, Gd^Esd, Dd, Rd, Dd, Gd, Gd, Gd
Dd^Esd, Dd^Fdy, Dd, Dd, Dd, Dd, Rd, Rd, Wwg, Wwg, Wwg, Gs, Dd^Vct, Dd, Dd^Vct, Rd, Dd, Dd, Dd, Gd
Dd, Dd, Rd, Rd, Rd, Rd, Dd, Rd, Wwg, Wwrg, Wwg, Rd, Rd, Dd, Dd, Rd, Dd, Dd, Dd^Fdw, Gs^Fdw
Dd, Dd, Rd, Dd, Dd, Dd, Dd^Tshy, Rd^Tshy, Wwg, Wwg, Wwf^Tshy, Rd^Tshy, Dd^Tshy, Dd, Rd, 1 Rd, Dd, Dd^Vct, Dd^Fdy, Dd^Fdw
Rd, Rd, Dd, Dd, Dd^Dr, Dd, Rd^Tshy, Rd^Tshy, Wwg, Wwg, Wwg, Rd^Tshy, Rd^Tshy, Dd^Tshy, Rd, Dd^Zulf, Dd, Dd^Fdy, Dd, Dd^Fdy
Dd, Dd, Dd, Dd^Esd, Dd, Dd, Dd^Tshy, Rd^Tshy, Rd^Tshy, Wwg, Wwg^Tshy, Rd^Tshy, Rd^Tshy, Dd^Tshy, Rd^Tshy, Dd, Dd, Dd, Dd^Esd, Dd
Dd, Dd^Esd, Dd, Dd, Dd, Dd, Rd, Rd^Tshy, Wwg, Wwg, Wwg, Rd^Tshy, Rd^Tshy, Dd^Tshy, Dd, Rd, Dd, Dd^Fdw, Dd, Dd
Dd, Dd, Dd, Dd, Rd, Rd^Vhcr, Rd, Rd^Tshy, Wwg, Wwrg, Wwrg, Rd^Tshy, Rd, Rd^Tshy, Dd, Rd, Rd, Dd, Dd^Esd, Dd
Qxe, Qxe, Qxe, Dd, Dd, Rd, Rd, Rd, Wwg, Wwrg, Wwrg, Wwrg, Rd, Rd, Dd, Dd, Rd, Dd, Dd, Dd^Es
