border_size=1
usage=map

Gg, Gg, Re^Gvs, Gg, Re^Gvs, Gg, Re^Gvs, Gg, Re^Gvs, Gg, Re^Gvs, Re^Gvs, Re^Gvs, Re^Gvs, Re^Gvs, Re^Gvs, Re^Gvs, Re^Gvs, Gg, Gg, Gg, Gg, Gg, Rp
Re, Re, Gg, Re, Gg, Gg, Gg, Gg, Gg, Re^Gvs, Re^Gvs, Re^Gvs, Re^Gvs, Re^Gvs, Re^Gvs, Re^Gvs, Re^Gvs, Gg, Gg, Gg, Gg, Rp, Rp, Rp
Gg, Gg, Re, Gg, Re, Re, Gg, Gg, Gg, Gg, Re^Gvs, Gg, Re^Gvs, Gg, Re^Gvs, Gg, Gg, Gg, Gg, Rp, Rp, Rp, Rp, Gg
Re^Gvs, Re^Gvs, Gg, Gg, Gg, Gg, Re, Re, Gs, Gs, Gg, Gg, Gg, Gg, Gg, Gg, Gg, Rp, Rp, Gg, Gg, Gg, Gg, Gg
Re^Gvs, Re^Gvs, Re^Gvs, Re^Gvs, Gg, Gg, Gg, Gg, Re, Re, Gs, Gg, Gg, Gg, Gg, Rp, Rp, Gg, Gg, Gg, Gg, Gs^Vc, Gg, Re^Gvs
Re^Gvs, Re^Gvs, Re^Gvs, Re^Gvs, Re^Gvs, Re^Gvs, Gg, Gg, Gg, Gg, Re, Re, Ce, Rp, Rp, Gg, Gg, Re^Gvs, Gg, Re^Gvs, Re^Gvs, Re^Gvs, Re^Gvs, Re^Gvs
Re^Gvs, Re^Gvs, Re^Gvs, Re^Gvs, Re^Gvs, Re^Gvs, Gg, Gg, Gg, Gg, Gg, Rp, Rp, Gg, Gg, Re^Gvs, Re^Gvs, Re^Gvs, Re^Gvs, Re^Gvs, Re^Gvs, Re^Gvs, Re^Gvs, Re^Gvs
Re^Gvs, Re^Gvs, Re^Gvs, Re^Gvs, Re^Gvs, Re^Gvs, Re^Gvs, Re^Gvs, Gg, Gg, Gg, Rp, Gg, Gg, Gg, Re^Gvs, Re^Gvs, Re^Gvs, Re^Gvs, Re^Gvs, Re^Gvs, Re^Gvs, Re^Gvs, Re^Gvs
Re^Gvs, Re^Gvs, Re^Gvs, Re^Gvs, Re^Gvs, Re^Gvs, Re^Gvs, Re^Gvs, Gg, Gg, Gg, Rp, Gg, Gg, Gg, Re^Gvs, Re^Gvs, Re^Gvs, Re^Gvs, Re^Gvs, Re^Gvs, Re^Gvs, Re^Gvs, Re^Gvs
Re^Gvs, Re^Gvs, Re^Gvs, Re^Gvs, Re^Gvs, Re^Gvs, Re^Gvs, Re^Gvs, Re^Gvs, Gg, Gg, Rp, Gg, Gg, Re^Gvs, Re^Gvs, Re^Gvs, Re^Gvs, Re^Gvs, Re^Gvs, Re^Gvs, Re^Gvs, Re^Gvs, Re^Gvs
Re^Gvs, Re^Gvs, Re^Gvs, Re^Gvs, Re^Gvs, Re^Gvs, Re^Gvs, Re^Gvs, Re^Gvs, Gg, Gg, Rp, Gg, Gg, Re^Gvs, Re^Gvs, Re^Gvs, Re^Gvs, Re^Gvs, Re^Gvs, Re^Gvs, Re^Gvs, Re^Gvs, Re^Gvs
Re^Gvs, Gg, Re^Gvs, Re^Gvs, Re^Gvs, Re^Gvs, Re^Gvs, Re^Gvs, Re^Gvs, Re^Gvs, Gg, Rp, Gg, Re^Gvs, Re^Gvs, Re^Gvs, Re^Gvs, Re^Gvs, Re^Gvs, Re^Gvs, Re^Gvs, Re^Gvs, Re^Gvs, Re^Gvs
Gg, Gg, Gg, Gs, Re^Gvs, Re^Gvs, Re^Gvs, Gs, Gg, Gg, Gg, Rp, Gg, Re^Gvs, Re^Gvs, Re^Gvs, Gg, Gg, Re^Gvs, Gg, Re^Gvs, Re^Gvs, Re^Gvs, Gg
Gs, Gg, Gg, Re^Gvs, Re^Gvs, Re^Gvs, Gg, Gg, Gg^Vh, Gg, Gg, Rp, Gg, Re^Gvs, Re^Gvs, Gg, Gg^Vh, Gg, Gg, Gg, Gg, Gg, Gs, Gg
Gg, Gg, Gg, Gg, Gg, Gg, Gg, Ww, Gg^Vh, Ww, Gg, Rr, Gg, Gg, Gg, Gg^Vh, Gg, Ww, Gg, Ww, Ww, Ww, Ww, Ww
Gg, Ww, Ww, Ww, Ww, Ww, Ww, Ww, Ww, Ww, Ww, Ww^Bw|, Ww, Ww, Ww, Ww, Ww, Ww, Ww, Ww, Ww, Ww, Ww, Ww
Ww, Ww, Ww, Ww, Ww, Ww, Ww, Chr, Chr, Ww, Ww, Rr, Ww, Chr, Ww, Ww, Ww, Wo, Ww, Wo, Ww, Wo, Wo, Wo
Ww, Wo, Wo, Ch, Wo, Wo, Wo, Gg^Vh, Gg, Gs, Gg, Rr, Gg, Gg, Chr, Gg^Vh, Hh, Hh, Wo, Hh, Wo, Hh, Hh, Hh
Ww, Rr, Ch, Gg^Vh, Hh, Hh, Hh, Gg, Gg, Gg, Gg, Rr, Gg, Gs, Gg, Gg, Gg, Gg, Hh, Rr, Hh, Rr, Rr, Rr
Rr, Gg, Rr, Rr, Gg, Rr, Rr, Rr, Rr, Rr, Rr, Rr, Rr, Rr, Gg, Rd, Gg, Rr, Rr, Gg, Rr, Ch, Ch, Gg
Gg, Gg, Gg, Gg, Rr, Gg, Gg, Gg, Gg, Gs, Gg, Rr, Gg, Gg, Rd, Rd, Rd, Gs^Fdf, Rr, Rr, Gg, Chr, Rp^Vhc, Ch
Gg, Ch, Ch, Gg, Rr, Gg, Chr, Chr, Dd, Rd, Rd, Gs^Fdw, Rd, Ce, Dd, Rd, Dd^Fdw, Gs^Fdf, Gs^Fdf, Rr, Gg, Gg, Gg, Ch
Gg, Ch, Rp^Vhc, Ch, Ch, Chr, Rp^Vhc, Chr, Dd, Rd, Dd^Fdw, Dd^Fdf, Rd, Dd, Dd^Es, Rd, Dd^Fdw, Dd^Fdw, Dd^Fdw, Rr, Dd, Rr, Rr, Gg
Gg, Gg, Gg, Ch, Khr, Chr, Dd, Dd, Dd, Rd, Dd^Fdw, Dd^Fdw, Rd, Rd, Dd, Rd, Rd, Rd, Rd, Dd, Rd, Dd, Dd, Ch
Rr, Rr, Rr, Gg, Chr, Dd, Dd, Dd, Dd, Dd^Fdw, Dd^Fdw, Rd, Rd, Rd, Rd, Rd, Dd, Dd, Dd^Es, Ce^Es, Rd, Dd, Dd, Dd
Rr, Gg, Gg, Ch, Rp^Vhc, Chr, Dd, Dd^Es, Dd, Dd, Dd, Dd, Qxe, Rd, Qxe, Dd, Rd, Rd, Dd^Es, Rd, Rd, Rd, Rd, Rd
Rr, Gg, Gg, Dd, Chr, Dd, Dd, Dd, Dd, Re, Qxe, Qxe, Qxe, Qxe, Qxe, Qxe, Qxe, Re, Rd, Rd, Rd, Dd, Dd, Dd
Rr, Rr, Rr, Rr, Dd, Rr, Dd, Dd, Qxe, Qxe, Qxe, Qxe, Qxe, Qxe, Qxe, Qxe, Qxe, Qxe, Qxe, Rd, Dd, Dd^Es, Dd^Es, Dd
Gg, Rr, Dd, Ce, Dd, Dd, Dd, Dd, Qxe, Qxe, Qxe, Qxe, Qxe, Qxe, Qxe, Qxe, Qxe, Qxe, Qxe, Qxe, Dd, Dd, Dd^Es, Dd
Gg, Rr, Ce, Ce, Dd, Dd^Es, Dd^Es, Dd, Qxe, Qxe, Qxe, Qxe, Qxe, Qxe, Qxe, Qxe, Qxe, Qxe, Qxe, Qxe, Rd, Rd, Dd, Rd
Gg, Rr, Dd, Dd, Dd, Dd^Es, Dd^Es, Dd, Qxe, Qxe, Qxe, Qxe, Qxe, Qxe, Qxe, Qxe, Qxe, Qxe, Qxe, Qxe, Dd, Dd^Es, Rd, Rd
Gg, Rr, Dd, Dd, Dd, Dd, Dd, Dd, Qxe, Qxe, Qxe, Qxe, Qxe, 1 Qxe, Qxe, Qxe, Qxe, Qxe^Zclb, Qxe, Qxe, Dd^Es, Dd^Es, Dd, Rd
Gg, Gg, Dd, Dd, Dd, Dd^Es, Dd, Dd, Qxe, Qxe, Qxe, Qxe, Qxe, Qxe, Qxe, Qxe, Qxe, Qxe, Qxe, Qxe, Rd, Rd, Rd, Rd
Ch, Gg, Rd, Dd, Dd, Dd, Dd, Dd, Qxe, Qxe, Qxe, Qxe, Qxe, Qxe, Qxe, Qxe, Qxe, Qxe, Qxe, Qxe, Dd, Dd^Es, Dd, Dd
Gg, Gg, Rd, Dd, Ce, Rd, Rd, Dd^Fdw, Qxe, Qxe, Qxe, Qxe, Qxe, Qxe, Qxe, Qxe, Qxe, Qxe, Qxe, Rd, Dd, Dd^Es, Ce^Es, Dd
Ww, Ww^Bw/, Rd, Rd, Rd, Rd, Dd^Fdw, Dd^Fdw, Qxe, Qxe, Qxe, Qxe, Qxe, Qxe, Qxe, Qxe, Qxe, Qxe, Dd, Dd, Rd, Rd, Dd, Rr
Ww^Bw/, Ww, Ww, Ch, Dd, Rd, Gs^Fdw, Rd, Rd, Qxe, Qxe, Qxe, Qxe, Qxe, Qxe, Qxe, Ce, Ce, Ce, Rd, Rd, Dd^Fdw, Dd, Dd^Fdf
