border_size=1
usage=map

Gg, Gg, Re^Gvs, Gg, Re^Gvs, Gg, Re^Gvs, Gg, Re^Gvs, Gg, Re^Gvs, Re^Gvs, Re^Gvs, Re^Gvs, Re^Gvs, Re^Gvs, Re^Gvs, Re^Gvs, Gg, Gg, Gg, Gg, Gg, Rp
Re, Re, Gg, Re, Gg, Gg, Gg, Gg, Gg, Re^Gvs, Re^Gvs, Re^Gvs, Re^Gvs, Re^Gvs, Re^Gvs, Re^Gvs, Re^Gvs, Gg, Gg, Gg, Gg, Rp, Rp, Rp
Gg, Gg, Re, Gg, Re, Re, Gg, Gg, Gg, Gg, Re^Gvs, Gg, Re^Gvs, Gg, Re^Gvs, Gg, Gg, Gg, Gg, Rp, Rp, Rp, Rp, Gg
Re^Gvs, Re^Gvs, Gg, Gg, Gg, Gg, Re, Re, Gs, Gs, Gg, Gg, Gg, Gg, Gg, Gg, Gg, Rp, Rp, Gg, Gg, Gg, Gg, Gg
Re^Gvs, Re^Gvs, Re^Gvs, Re^Gvs, Gg, Gg, Gg, Gg, Re, Re, Gs, Gg, Gg, Gg, Gg, Rp, Rp, Gg, Gg, Gg, Gg, Gs^Vc, Gg, Re^Gvs
Re^Gvs, Re^Gvs, Re^Gvs, Re^Gvs, Re^Gvs, Re^Gvs, Gg, Gg, Gg, Gg, Re, Re, Ce, Rp, Rp, Gg, Gg, Re^Gvs, Gg, Re^Gvs, Re^Gvs, Re^Gvs, Re^Gvs, Re^Gvs
Re^Gvs, Re^Gvs, Re^Gvs, Re^Gvs, Re^Gvs, Re^Gvs, Gg, Gg, Gg, Gg, Gg, Rp, Rp, Gg, Gg, Re^Gvs, Re^Gvs, Re^Gvs, Re^Gvs, Re^Gvs, Re^Gvs, Re^Gvs, Re^Gvs, Re^Gvs
Re^Gvs, Re^Gvs, Re^Gvs, Re^Gvs, Re^Gvs, Re^Gvs, Re^Gvs, Re^Gvs, Gg, Gg, Gg, Rp, Gg, Gg, Gg, Re^Gvs, Re^Gvs, Re^Gvs, Re^Gvs, Re^Gvs, Re^Gvs, Re^Gvs, Re^Gvs, Re^Gvs
Re^Gvs, Re^Gvs, Re^Gvs, Re^Gvs, Re^Gvs, Re^Gvs, Re^Gvs, Re^Gvs, Gg, Gg, Gg, Rp, Gg, Gg, Gg, Re^Gvs, Re^Gvs, Re^Gvs, Re^Gvs, Re^Gvs, Re^Gvs, Re^Gvs, Re^Gvs, Re^Gvs
Re^Gvs, Re^Gvs, Re^Gvs, Re^Gvs, Re^Gvs, Re^Gvs, Re^Gvs, Re^Gvs, Re^Gvs, Gg, Gg, Rp, Gg, Gg, Re^Gvs, Re^Gvs, Re^Gvs, Re^Gvs, Re^Gvs, Re^Gvs, Re^Gvs, Re^Gvs, Re^Gvs, Re^Gvs
Re^Gvs, Re^Gvs, Re^Gvs, Re^Gvs, Re^Gvs, Re^Gvs, Re^Gvs, Re^Gvs, Re^Gvs, Gg, Gg, Rp, Gg, Gg, Re^Gvs, Re^Gvs, Re^Gvs, Re^Gvs, Re^Gvs, Re^Gvs, Re^Gvs, Re^Gvs, Re^Gvs, Re^Gvs
Re^Gvs, Gg, Re^Gvs, Re^Gvs, Re^Gvs, Re^Gvs, Re^Gvs, Re^Gvs, Re^Gvs, Re^Gvs, Gg, Rp, Gg, Re^Gvs, Re^Gvs, Re^Gvs, Re^Gvs, Re^Gvs, Re^Gvs, Re^Gvs, Re^Gvs, Re^Gvs, Re^Gvs, Re^Gvs
Gg, Gg, Gg, Gs, Re^Gvs, Re^Gvs, Re^Gvs, Gs, Gg, Gg, Gg, Rp, Gg, Re^Gvs, Re^Gvs, Re^Gvs, Gg, Gg, Re^Gvs, Gg, Re^Gvs, Re^Gvs, Re^Gvs, Gg
Gs, Gg, Gg, Re^Gvs, Re^Gvs, Re^Gvs, Gg, Gg, Gg^Vh, Gg, Gg, Rp, Gg, Re^Gvs, Re^Gvs, Gg, Gg^Vh, Gg, Gg, Gg, Gg, Gg, Gs, Gg
Gg, Gg, Gg, Gg, Gg, Gg, Gg, Ww, Gg^Vh, Ww, Gg, Rr, Gg, Gg, Gg, Gg^Vh, Gg, Ww, Gg, Ww, Ww, Ww, Ww, Ww
Gg, Ww, Ww, Ww, Ww, Ww, Ww, Ww, Ww, Ww, Ww, Ww^Bw|, Ww, Ww, Ww, Ww, Ww, Ww, Ww, Ww, Ww, Ww, Ww, Ww
Ww, Ww, Ww, Ww, Ww, Ww, Ww, Chr, Chr, Ww, Ww, Rr, Ww, Chr, Ww, Ww, Ww, Wo, Ww, Wo, Ww, Wo, Wo, Wo
Ww, Wo, Wo, Ch, Wo, Wo, Wo, Gg^Vh, Gg, Gs, Gg, Rr, Gg, Gg, Chr, Gg^Vh, Hh, Hh, Wo, Hh, Wo, Hh, Hh, Hh
Ww, Rr, Ch, Gg^Vh, Hh, Hh, Hh, Gg, Gg, Gg, Gg, Rr, Gg, Gs, Gg, Gg, Gg, Gg, Hh, Rr, Hh, Rr, Rr, Rr
Rr, Gg, Rr, Rr, Gg, Rr, Rr, Rr, Rr, Rr, Rr, Rr, Rr, Rr, Gg, Rr, Gg, Rr, Rr, Gg, Rr, Ch, Ch, Gg
Gg, Gg, Gg, Gg, Rr, Gg, Gg, Gg, Gg, Gs, Gg, Rr, Gg, Gg, Rr, Rr, Rr, Gs^Fdf, Rr, Rr, Gg, Chr, Rp^Vhc, Ch
Gg, Ch, Ch, Gg, Rr, Gg, Ch, Chr, Gg, Rr, Rr, Gs^Fdw, Rr, Ce, Ce, Rr, Gs^Fdw, Gs^Fdf, Gs^Fdf, Rr, Gg, Gg, Gg, Ch
Gg, Ch, Rp^Vhc, Ch, Ch, Ch, Rp^Vhc, Chr, Gg, Rr, Gs^Fdf, Gs^Fdf, Rr, Gg, Ce, Rr, Gs^Fdf, Gs^Fdw, Gs^Fdf, Rr, Gg, Rr, Rr, Gg
Gg, Gg, Gg, Ch, Kh, Ch, Gg, Gg, Gg, Rr, Gs^Fdf, Gs^Fdf, Rr, Rr, Gg, Rr, Rr, Rr, Rr, Gg, Rr, Gg, Gg, Ch
Rr, Rr, Rr, Gg, Ch, Gg, Rr, Rr, Rr, Gs^Fdw, Gs^Fdf, Rr, Rr, Rr, Rr, Rr, Gg, Gg, Ce, Ce, Rr, Gg, Gg, Gg
Rr, Gg, Gg, Ch, Rp^Vhc, Ch, Gg, Gs, Rr, Rr, Rr, Gg, Gg, Rr, Gg, Gg, Rr, Rr, Ce, Rr, Rr, Rr, Rr, Rr
Rr, Gg, Gg, Gg, Ch, Gg, Gg, Rr, Rr, Gg, Gg, Ss, Ss, Ss^Bw|, Ss, Ss, Gg, Gg, Rr, Rr, Rr, Gg, Gg, Gs
Rr, Rr, Rr, Rr, Gg, Rr, Gg, Rr, Gg, Ss, Ss, Chs, Rp^Vhc, Rr, Rp^Vhc, Ch, Ss, Ss, Gg, Rr, Gg, Ce, Ce, Gg
Gg, Rr, Gg, Ce, Rr, Gs^Fdf, Rr, Rr, Ss, Chs, Chs, Gg, Gg, Rr, Gs, Gg, Ch, Chr, Ss, Rr, Gg, Gg, Ce, Gg
Gg, Rr, Ce, Ce, Rr, Gs^Fdw, Gs^Fdf, Rr, Ss, Chs, Gg, Gg, Gg, Chr, Gg, Gs, Gg, Ch, Ss, Rr, Rr, Rr, Gg, Rr
Gg, Rr, Gg, Gg, Rr, Gs^Fdf, Gs^Fdw, Rr, Ss, Chs, Gg, Gg, Chr, Khr, Chr, Gg, Gg, Ch, Ss, Rr, Gg, Ce, Rr, Rr
Gg, Rr, Gg, Rr, Rr, Rr, Rr, Rr, Ss, Rp^Vhc, Gg, Rr, Chr, 1 Chr, Chr, Rr, Gs, Rp^Vhc, Ss, Rr, Ce, Ce, Gg, Rr
Gg, Gg, Rr, Gg, Gg, Gs, Gs, Rr, Ss, Ss^Bw/, Rr, Gg, Gg, Gs, Gg, Gg, Rr, Ss^Bw\, Ss, Rr, Rr, Rr, Rr, Rr
Ch, Gg, Rr, Gg, Ce, Ce, Gg, Rr, Rr, Ss, Rp^Vhc, Chr, Gg, Gg, Gg, Ch, Rp^Vhc, Ss, Rr, Rr, Gg, Ce, Gg, Gg
Gg, Gg, Rr, Gg, Ce, Rr, Rr, Gs^Fdf, Rr, Rr, Ss, Ss, Ch, Chr, Ch, Ss, Ss, Rr, Rr, Rr, Gg, Ce, Ce, Gg
Ww, Ww^Bw/, Rr, Rr, Rr, Rr, Gs^Fdf, Gs^Fdf, Gs^Fdf, Rr, Rr, Rr, Ss, Ss, Ss, Rr, Rr, Ce, Gg, Gg, Rr, Rr, Gg, Rr
Ww^Bw/, Ww, Ww, Ch, Gg, Rr, Gs^Fdw, Rr, Rr, Gg, Gg, Ce, Rr, Rr, Rr, Gg, Ce, Ce, Ce, Rr, Rr, Gs^Fdf, Rr, Gs^Fdf
