border_size=1
usage=map

Gll^Fp, Gll^Fp, Gll^Fp, Gll^Fp, Gll^Fp, Gll^Fp, Gll^Fp, Gll^Fp, Gs, Hh, Hh, Mm, Mm, Mm, Mm, Mm, Mm, Mm, Mm, Hh, Hh, Hh^Fp, Hh^Fp, Hh^Fp, Hh^Fp, Hh^Fp, Hh^Fp, Hh^Fp, Hh^Fp, Hh^Fp, Mm, Mm, Mm, Mm, Mm, Mm, Mm, Hhd
Gll^Fp, Gll^Fp, Gll^Fp, Gll^Fmw, Gll^Fp, Gll^Fp, Gll^Fp, Gll^Fp, Gs, Gs, Gs, Hh, Hh, Mm, Mm, Mm, Mm, Mm, Hh, Hh, Gll^Fp, Hh^Fp, Gll^Fp, Gll^Fp, Gll^Fp, Gll^Fp, Gll^Fp, Gll^Fp, Hh, Hh^Fp, Hh, Hh, Hh, Hhd, Hhd, Hhd, Hhd, Hhd
Gll^Fp, Gll^Fp, Gg, Gll^Fp, Gll^Fmw, Gll^Fmw, Gll^Fmw, Gll^Fmw, Gg, Gs, Gg, Gs, Hh, Mm, Hh, Hh, Hh, Mm, Hh, Gd, Gs, Gll^Fp, Gll^Fp, Gll^Fp, Hh^Fp, Gll^Fp, Gs, Gs, Gs, Hh, Hh^Fp, Hh, Gs, Hh, Hh, Hh, Gs, Hhd
Gll^Fmw, Gll^Fmw, Gg, Gg, Gg, Gll^Fmw, Gg, Gll^Fmw, Gg, Gg, Gg, Gs, Hh, Hh, Hh, Gs, Gs, Hh, Gs, Gs, Gs, Gll^Fp, Gll^Fp, Hh^Fp, Gll^Fp, Gs, Gs, Gs, Gll^Fp, Gs, Gg^Fp, Gg^Fp, Gs, Gs, Gs, Gs, Gd, Gg
Ss, Gg, Gg, Gg, Ss, Gg, Ss, Gg, Gg, Gg, Gg, Gg, Gg, Gg, Gg, Gs, Gg, Gs, Gg, Gg, Gg, Gll^Fp, Gll^Fp, Gll^Fp, Gll^Fp, Gll^Fp, Gs, Gg, Gg, Gs, Gs, Gs, Gs, Gs, Gs, Gd, Gd, Gd
Ww, Ss, Ss, Ss, Ss, Ss, Ss, Gg, Ss, Gg, Gg, Gg, Gg, Gg, Gg, Gg, Gg, Gg, Gg, Gg, Gg, Gg, Gll^Fmw, Gll^Fp, Gll^Fp, Gll^Fmw, Gg, Gg, Gg, Gg, Gg, Gs, Gll^Fmw, Gs, Gs, Gd, Gd, Gs
Ww, Ww, Ww, Ww, Ww, Ww^Ewl, Ww, Ss, Ww, Ss, Ss, Ss, Ss, Ss, Ss, Ss, Ss, Gg, Gg, Gg, Gg, Gg, Gll^Fmw, Gll^Fmw, Gll^Fp, Gll^Fp, Gg, Gll^Fmw, Gg, Gg, Gg, Gg, Gg, Gg, Gg, Gs, Gs, Gs
Ss, Ww, Ww, Ww, Ww, Ww, Ww, Ww, Ww, Ww, Ww, Ww, Ww, Ww, Ww, Ww, Ww, Ss, Ss, Gg, Gg, Gg, Gll^Fmw, Gll^Fp, Gll^Fp, Gll^Fp, Gg, Gg, Gg, Gll^Fmw, Gll^Fmw, Gg, Gll^Fp, Gll^Fp, Gll^Fp, Gg, Gg, Gs
Gg, Ss, Ss, Ss, Ss, Ss, Ss, Ww, Ss, Ww, Ss, Ww, Ww, Ww, Ww, Ww, Ww, Ww, Ww, Ss, Ss, Gll^Fp, Gll^Fp, Gll^Fp, Gll^Fp, Gll^Fp, Gg, Gg, Gg, Gg, Gll^Fmw, Gll^Fmw, Gll^Fp, Gll^Fp, Gll^Fp, Gg, Gg, Gg
Gg, Gg, Gg, Gg, Gg, Ss, Gg, Ss, Gg, Ss, Gg, Ss, Ss, Ss, Ss, Ss, Ss, Ww, Ww, Ww, Ww, Gll^Fp, Ww, Gll^Fp, Gll^Fp, Ss, Ss, Gg, Gg, Gg, Gg, Gg, Gg, Gll^Fmw, Gg, Gg, Gs, Gg
Rb, Rb, Rb, Gg, Gg, Gg, Gg, Gg, Gg, Gg, Gg, Gg, Gg, Gg, Gg, Gg, Gg, Ss, Ss, Ww, Ww, Ww, Gll^Fp, Ww, Ww, Ss, Ww, Ss, Ss, Gg, Gg, Gg, Gg, Gg, Gg, Gg, Gs, Gs
Rb, Rb, Rb, Rb, Gg, Gg, Gs, Gg, Gs, Gll^Fmw, Gs, Gs, Gs, Gg, Gg, Gg, Gg, Gg, Gg, Ss, Ss, Ss, Gll^Fp, Gll^Fp, Gll^Fp, Ww, Ww, Ss, Ss, Gg, Gg, Gg, Gg, Gg, Gg, Gg, Gd, Gs
Gg, Rb, Rb, Rb, Rb, Gg, Gg, Gs, Gs, Gs, Gg, Gs, Gg, Gg, Rb, Rb, Rb, Gg, Gg, Gg, Gg, Gg, Gll^Fp, Gll^Fp, Gll^Fp, Ss, Ss, Ww, Ss, Gg, Gs, Gg, Gg, Gg, Re^Vct, Gg, Gs, Gd
Gg, Rb, Rb, Rb, Rb, Rb, Rb, Rb, Rb, Re^Vct, Gg, Gg, Rb, Rb, Rb, Rb, Re, Rb, Gg, Gg, Gg, Gg, Gll^Fp, Gll^Fp, Gll^Fp, Gll^Fp, Ss, Ww, Ss, Gs, Gs, 1 Gs, Gs, Gg, Gg, Gs, Gs, Gs
Gg, Gg, Gg, Re^Vct, Rb, Rb, Rb, Rb, 3 Rb, Rb, Rb, Rb, Rb, Rb, Re, Re, Rb, Rb, Rb, Gg, Gg, Gg, Gll^Fmw, Gll^Fp, Ss, Gll^Fp, Ss, Ww, Ww, Gg, Gg, Gs, Gs, Ce, Gs, Gg, Gg, Gs
Gg, Gg, Gg, Gg, Ce, Rb, Rb, Rb, Rb, Rb, Rb, Rb, Re, Re, Re, Re, Gg, Rb, Rb, Rb, Gg, Gg, Gll^Fmw, Gll^Fmw, Gll^Fmw, Gll^Fp, Ss, Ww, Ww, Gg, Gg, Gg, Gg, Gg, Gs, Re^Vct, Gg, Gg
Gg, Gg, Gg, Gg, Ce, Ce, Ce, Gg, Gg^Ecf, Rb, Rb, Rb, Rb, Re, Gg, Gg, Gg, Rb, Rb, Rb, Rb, Gg, Gg, Gll^Fmw, Gll^Fmw, Gll^Fp, Gll^Fp, Ss, Ss, Ww, Ww, Gg, Gg, Gg, Gg, Gs, Gg, Gg
Gg, Gg, Gg, Gg, Gg, Ce, Gg, Gg, Gg, Ce, Ce, Gg, Re^Vct, Gg, Gg, Gg, Gg, Rb, Rb, Re, Re, Rb, Rb, Gg, Gll^Fp, Gll^Fp, Gll^Fp, Gll^Fp, Ss, Ww^Ewl, Ww, Ww, Ww, Gg, Gg, Gg, Gg, Gg
Gg, Gg, Gg, Gs, Gs, Gs, Gs, Gs, Gs, Ce, Gg, Gg, Gg, Gg, Gg, Gg, Gg, Gg, Gg, Rb, Re, Re, Rb, Gg, Gg, Gll^Fp, Gll^Fp, Ss, Gll^Fp, Ss, Ss, Ww, Ww, Gg, Gg, Gg, Gg, Gg
Gg, Gg, Gg, Gg, Gg, Gs, Gg, Gs, Gs, Gs, Gs, Gg, Gg, Gg, Gg, Gs, Hh, Gg, Gg, Rb, Rb, Re, Rb, Gg, Gg, Gll^Fp, Gll^Fp, Gll^Fp, Gll^Fp, Gll^Fp, Gll^Fp, Ww, Gg, Gll^Fmw, Gll^Fmw, Gg, Gg, Gg
Gg, Gg, Gll^Fp, Gg, Gll^Fp, Gg, Gg, Gg, Gg, Gs, Gs, Gs, Gg, Rb, Gg, Hh^Fmw, Hh, Gs, Gg, Gg, Gg, Rb, Rb, Rb, Rb, Gg, Gg, Gll^Fp, Gll^Fp, Gll^Fp, Gll^Fp, Ww, Gll^Fp, Gg, Gg, Gg, Gg, Gg
Gll^Fp, Gll^Fp, Gll^Fp, Gll^Fp, Gll^Fp, Gll^Fp, Gll^Fp, Gg, Gg, Gg, Gg, Gg, Gll^Fmw, Gg, Gll^Fmw, Gg^Fmw, Gs, Gs, Gg, Gg, Gg, Rb, Rb, Rb, Rb, Gg, Gg, Gg, Gll^Fp, Gll^Fp, Ww, Ww, Gll^Fp, Gll^Fp, Gll^Fp, Gg, Gg, Gg
Gll^Fp, Gll^Fp, Gll^Fp, Gll^Fp, Gll^Fp, Gll^Fp, Gll^Fp, Gll^Fp, Gll^Fp, Gg, Gg, Gg, Gg, Gg, Gll^Fmw, Gll^Fmw, Gs, Gs, Gs, Gg, Gg, Gg, Gg, Rb, Rb, Rb, Rb, Gg, Gg, Gll^Fp, Ww, Ww, 4 Gll^Fmw, Gll^Fp, Gll^Fp, Gll^Fp, Gll^Fp, Gg
Gg, Gll^Fp, 2 Gg, Gll^Fp, Gg, Gll^Fp, Gll^Fp, Gll^Fp, Gll^Fp, Gll^Fmw, Gll^Fmw, Gg, Gs, Gg, Gs, Gg, Hh, Hh, Hh, Gs, Gg, Gg, Gg, Gg, Gg, Rb, Rb, Rb, Rb, Gg, Gg, Ww, Gll^Fmw, Gll^Fp, Gll^Fmw, Gll^Fp, Gll^Fp, Gg
Gg, Gg, Gg, 5 Gg, Gg, Gg, Gll^Fp, Gll^Fp, Gll^Fmw, Gll^Fp, Gll^Fp, Gll^Fmw, Hh^Fp, Gs, Hh, Hh, Hh, Hh, Hh, Gs, Gs, Gg, Gg, Gg, Gll^Fmw, Gg, Gg, Rb, Rb, Rb, Rb, Ww, Ww, Gll^Fmw, Gll^Fp, Gll^Fp, Gll^Fp, Gll^Fp
Gg, Gg, Gg, Gg, Gll^Fmw, Gll^Fmw, Gll^Fmw, Gll^Fmw, Gll^Fp, Gll^Fp, Hh^Fp, Hh^Fp, Hh^Fp, Hh^Fp, Hh, Mm, Mm, Mm, Hh, Hh, Gs, Gll^Fmw, Gll^Fmw, Gll^Fmw, Gll^Fmw, Gll^Fmw, Gll^Fmw, Gs, Rb, Rb, Rb, Rb, Rb, Ww, Ww, Gll^Fp, Gll^Fp, Gll^Fp
