border_size=1
usage=map

Ms^Xm, Ms^Xm, Ms^Xm, Ms, Ms^Xm, Ms^Xm, Ms^Xm, Ms^Xm, Ms^Xm, Ms^Xm, Ms^Xm, Ms, Ms, Ms, Ms, Ms, Ms, Ms, Ms, Ms, Ms, Ms, Ms, Ms, Ms, Ms, Ms^Xm, Ms^Xm, Ms^Xm, Ms^Xm, Ms^Xm, Ms^Xm, Ms^Xm
Ms^Xm, Ms^Xm, Ms^Xm, Ms^Xm, Ms, Ms^Xm, Ms, Ms^Xm, Ms, Ms, Aa, Ms, Aa, Ms, Aa, Ms, Ms, Ms, Aa^Fpa, Ms, Ms, Ms, Ms, Ms, Ms, Ms, Ms, Ms^Xm, Ms, Ms^Xm, Ms^Xm, Ms, Ms
Ms^Xm, Ms^Xm, Ms, Ms, Ms, Ms, Ms, Ms, Aa, Aa, Ai, Aa, Aa, Aa, Aa^Fpa, Aa, Aa, Aa, Aa^Voa, Aa^Fpa, Aa, Ms, Ms, Ms, Ms, Ms, Ms, Ms, Ms, Ms, Ms, Ms^Xm, Ms^Xm
Ms^Xm, Ms, Ms, Ms, Ms, Ms, Aa^Fpa, Aa^Fpa, Ai, Ai, Wwg, Ai, Ai, Aa, Ai, Aa^Voa, Ai, Ai, Ai, Ai, Ai, Aa, Aa, Ms, Ms, Ms, Ms, Ms, Aa^Fpa, Ms, Ms, Ms, Ms
Ms, Ms, Ms, Ms, Aa, Aa^Fpa, Ai, Aa^Fpa, Ai, Ai, Wwg, Wwg, Wwg, Ai, Ai, Ai, Ai, Ai, Ai, Ai, Ai, Ai, Aa^Fpa, Aa, Aa, Ms, Ms, Ms, Aa, Aa^Fpa, Aa^Fpa, Ms, Ms
Ms, Ms, Aa, Aa, Aa, Ai, Wwg, Ai, Wwg, Wwg, Wog, Wwg, Wwg, Wwg, Wwg, Wwg, Wwg, Ai, Wwg, Ai, Ai, Ai, Ai, Aa, Aa, Ms, Coa, Coa, Coa, Aa, Aa, Aa, Ms
Ms, Ms, Aa, Aa, Ai, Ai, Wwg, Wwg, Wwg, Wwg, Wog, Wog, Wwg, Wwg, Ai, Ai, Aa^Fpa, Wwg, Wwg, Wwg, Wwg, Ai, Wwf, Rb, Rb, Aa, Coa, 5 Koa, Coa, Rb, Rb, Aa, Aa
Ms, Ha, Aa, Aa, Aa, Ai, Wwg, Ai, Ai, Wwg, Wwg, Wog, Wwg, Wwg, Wwg, Ai, Ai, Wwg, Wwg, Wwg, Wwf, Wwf, Wwf, Wwf, Ai^Bw/r, Rb, Ai, Coa, Rb, Rb, Aa^Voa, Aa, Aa^Fpa
Ha, Ha, Ha, Aa, Aa, Ai, Wwg, Wwg, Ai, Ai, Wwg, Wwg, Wwg, Wwg, Wog, Wwg, Wwg, Wwg, Wwg, Wwg, Wwf, Wwf, Wwf^Bw/r, Ai^Bw/r, Wwf, Ai, Ai, Ai, Rb, Rb, Ai, Ai, Aa^Fpa
Hh, Ha, Ha, Aa, Aa, Ai, Wwg, Wwg, Ai, Wwg, Wwg, Wwg, Ww, Wwg, Wog, Wwg, Wwg, Wwg, Wwg, Wwg, Wwg, Wwf, Wwf, Wwf, Wwf, Wwf, Wwf, Wwf, Wwf^Bw|r, Ai, Ai, Ai, Aa
Hh, Hh, Hh, Ai, Aa, Ai, Wwg, Wwg, Wwg, Wwg, Wwg, Wwg, Wwg, Wwg, Wwg, Wwg, Wwg, Wwg, Wwg, Wwg, Wwg, Wwg, Wwg, Wwf, Wwf, Wwf, Wwf, Wwf, Wwg^Bw|r, Ai, Ai, Ai, Ai
Hh^Fp, Hh, Hh, Aa, Ai, Ai, Wwg, Wwg, Wwg, Wwg, Ww, Wwg, Ww, Wwg, Wwg, Ww, Wwg, Wwg, Wwg, Ai, Wwg, Wwg, Wwg, Wwg, Wwg, Wwf, Wwg, Wwg, Wwg^Bw|r, Wwg, Wwg, Ai, Ai
Hh^Fp, Hh^Fp, Hh, Aa, Ai, Ai, Ds, Wwg, Ds, Ww, Ww, Ww, Ww, Ww, Ww, Wwg, Wwg, Wwg, Wwg, Wwg, Ai, Ai, Wwf, Wwg, Wwg, Wwg, Wwg, Wwg, Wwg, Wwg, Wwg, Ai, Ai
Hh^Fp, Hh, Hh, Ai, Ai, Ai, Ds, Ds, Ds, Ww, Ww, Ww, Ww, Ww, Ww, Ww, Ww, Ww, Ww, Wwg, Gll^Fp, Ai, Ai, Wwg, Ww, Wwg, Wwg, Wwg, Wwg, Wwg, Ai, Ai, Wwg
Mm, Hh, Ss, Ss, Ss, Ai, Ds, Ds, Ds, Ds, Ds, Ww, Gll^Fp, Ww, Ww, Ww, Wwg, Ww, Gll^Fp, Gll^Fp, Gll^Fp, Gll^Fp, Ai, Wwg, Wwg, Wwg, Wwg, Ai, Wwg, Wwg, Wwg, Wwg, Wwg
Mm, Ds, Ss, Ss, Ss, Ss, Ds, Ds, Ds, Ds^Fdw, Hh^Fp, Hh, 4 Re^Vct, Gll^Fp, Gll^Fp, Ww, Ww, Ww, Wwf, Gll^Fp, Gll^Fp, Gll^Fp, Ww, Ww, Ww, Ww, Ww, Wwg, Wwg, Wwg, Wwg, Wwg, Ww
Mm, Mm, Mm, Ss, Ss, Hh, Hh, Ds, Ds, Gll^Fdw, Hh, Hh, Re, Gg, Gll^Fp, Wwf, Ww, Ww, Ww, Ww, Ww, Ww, Ww, Ww, Wwg, Ww, Ww, Ww, Ww, Ww, Ww, Ww, Ww
Mm, Mm, Mm, Ss, Ss, Hh^Fp, Hh, Hh, Ww, Gg, Ww, Re, Gll^Ecf, Gll^Fp, Gll^Fp, Wwf, Ww, Ww, Ww, Wwg, Ww, Ww, Ww, Ww, Ww, Ww, Ww, Ww, Wwg, Ww, Ww, Ww, Wo
Mm, Mm, Mm, Gg, Ds, Hh, Hh, Hh, Ww, Ds, Ds, Ww, Ww, Gll^Fp, Ww, Ww, Ww, Ww, Ww, Ww, Wo, Ww, Wo, Ww, Ww, Ww, Wwg, Wwg, Ww, Wwg, Ww, Wo, Wo
Mm, Mm, Gg, Gg, Ds, Ds, Ss, Gg, Ww, Ds, Ds, Ds, Ww, Ww, Ww, Ww, Ww, Ww, Ww, Wo, Wo, Wo, Wo, Ww, Ww, Ww, Ww, Wwg, Ww, Ww, Ww, Wo, Wo
Mm, Mm, Gg, Ss, Ss, Ss, Ss, Gg, Ww, Ww, Ww, Ww, Ww, Ww, Ww, Ww, Wo, Wo, Wo, Wo, Wo, Wo, Wo, Wo, Ww, Ww, Ww, Ww, Ww, Ww, Wo, Wo, Wo
Mm, Mm, Gg, Gg, Gg, Gg, Gg, Gg, Gg, Ww, Ww, Ww, Ww, Ww, Ww, Wo, Wo, Wo, Wo, Wo, Wo, Wo, Wo, Wo, Ww, Ww, Ww, Wo, Wo, Wo, Ww, Wo, Ww
Mm, Mm, Gg, Gll^Fp, Gg, Gg^Es, Gll^Fp, Gg, Gg, Gg, Ds, Ww, Ww, Ww, Ww, Ww, Ww, Wo, Wo, Wo, Ww, Ww, Ww, Ww, Ww, Ww, Ww^Bw|, Ww, Ww, Ww, Ww, Ww, Ww
Mm, Mm, Gg, Gg, Gll^Fp, Gll^Fp, Gll^Fp, Gll^Fp, Gg, Gg, Ds, Ds, Ds, Ww, Ds, Ww, Ww, Ww, Ww, Wo, Ww, Ww, Ww, Ww, Ds, Ww, Ds^Bw|, Ww, Ds, Ds, Ds, Ww, Ww
Mm, Mm, Mm, Gg, Gg, Gll^Fp, Gll^Fp, Gll^Fp, Gd, Gd, Gd, Ds, Gd, Ds, Ds, Ds, Wwf, Ww, Ww, Ww, Wwf, Ww, Ww, Wwf, Ds, Ds, Co, Ds, Co, Gg, Ds, Wwf, Ds
Mm, Mm, Mm, Gg, Gg, Gg, Gg, Gg, Gd, Gd, Re, Gd, Re, Gd, Gd, Ds, Gg, Wwf, Wwf, Ww, Ww, Ww, Ww, Ww, Ww, Ds, Gg, 2 Ko, Gg, Gg, Gg, Wwf, Ds
Mm, Mm, Mm, Mm, Mm, Gg, Gg, Gs, Gg, Re, Re, Re, Gg, Re, Re, Gg^Es, Gs, Gg, Gg, Ww, Ww, Ww, Ww, Ww, Ww^Bw/, Ds^Bw/, Wwf, Co, Wwf, Gg, Gg, Ds, Gg
Mm, Mm, Gg, Mm, Gg^Vct, Mm, Gg, Gg, Re, Re, Gg, Gg, Ss, Gg, Gg, Re, Re, Gs, Gg, Ss, Ww, Ww, Ww, Ww^Bw/, Ww, Ww, Ss, Wwf, Ss, Ss, Gd^Vo, Gg, Gg
Mm, Mm, Mm, Gg, Gg, Gg, Gg, Re, Gg, Gg, Ss, Ss, Ss, Ss, Gll^Fp, Gs, Gs, Re, Re, Gg, Ww, Ww, Ds, Ds^Bw|, Ds, Ww, Ww, Ss, Ss, Ss, Gg, Gg, Gg
Mm, Mm, Mm, Mm, Mm, Gg, Re, Re, Gg, Gg^Es, Gg, Ss, Gll^Fp, Ss, Ss, Ss, Re, Re, Gg, Re, Ww^Bw\, Ww, Re, Re, Ds, Ss, Mm, Ww, Ww, Gg, Gg, Gg^Es, Gg
Mm, Mm, Gg^Vct, Mm, Ce, Gg, Ce, Gg, Gg, Gg, 3 Gg, Gg, Gg, Gg, Gg, Re, Re, Re, Gg, Gg, Ww, Re, Gd^Vo, Re, Mm, Ss, Mm, Mm, Gg, Ww, Gg, Gg, Gg
Mm, Mm, Gg, Ce, Ce, 1 Ke, Ce, Ce, Gg, Mm, Mm, Mm, Mm, Gg, Gg, Gg, Gg, Gg, Ss, Ww, Gg, Gg, Gg, Gg, Mm, Mm, Gg, Gg, Ss, Ww, Ww, Ss, Gg
Gg, Gg, Gg, Gg, Re, Re, Re, Re, Gg, Mm, Mm, Mm, Mm, Mm, Gg, Ss, Ss, Ss, Ww, Ww, Ss, Ss, Ss, Ss, Ss, Gg, Gg, Ss, Ss, Ww, Ww, Ww, Ww