border_size=1
usage=map

Uue, Xue, Xue, Xue, Xue, Qxe, Qxe, Qxe, Qxe, Qxe, Qxe, Qxe, Qxe, Qxe, Qxe, Dd, Dd, Dd, Dd, Dd, Dd, Dd, Rd, Dd, Dd, Dd, Dd, Dd, Dd, Dd, Dd, Qxe, Qxe, Xue, Xue, Xue, Xue, Xue, Xue, Xue, Uue, Xue, Xue, Xue, Xue, Xue
Uue, Xue, Uue, Xue, Xue, Qxe, Qxe, Qxe, Qxe, Qxe, Qxe, Qxe, Qxe, Qxe, Qxe, Qxe, Qxe, Dd, Qxe, Dd, Dd, Dd, Rd, Dd, Dd, Dd, Qxe, Dd, Qxe, Qxe, Qxe, Qxe, Qxe, Uue, Uue, Uue, Uue, Uue, Uue, Uue, Xue, Xue, Xue, Xue, Xue, Xue
Xue, Uue, Uue, Uue, Uue, Uue, Uue, Qxe, Qxe, Qxe, Qxe, Qxe, Qxe, Qxe, Qxe, Qxe, Qxe, Qxe, Qxe, Tptz, Tptz^Ecf, Tptz, Rd, Tptz, Tptz^Ecf, Tptz, Qxe, Qxe, Qxe, Qxe, Qxe^Zcla, Qxe, Qxe, Qxe, Qxe, Uue, Uue, Uue, Uue, Uue, Xue, Uue, Xue, Xue, Xue, Xue
Xue, Xue, Xue, Uue, Uue, Uue, Uue, Uue, Uue, Qxe, Qxe, Qxe, Qxe, Qxe, Qxe, Tptz, Qxe, Qxe, Qxe, Tptz, Tptz, Tptz, Rd, Tptz, Tptz, Tptz, Qxe, Qxe, Qxe, Tptz, Qxe, Qxe, Qxe, Qxe, Qxe, Qxe, Qxe, Uue, Uue, Xue, Uue, Uue, Xue, Xue, Xue, Xue
Xue, Xue, Xue, Xue, Uue, Uue, Uue, Uue, Uue, Uue, Qxe, Qxe, Qxe, Qxe, Qxe, Qxe^Tphz, Qxe, Qxe, Qxe^Zcla, Qxe^Tphz, Dd^Tphz, Dd^Tphz, Rd, Dd^Tphz, Dd^Tphz, Qxe^Tphz, Qxe, Qxe, Qxe, Qxe^Tphz, Qxe, Qxe, Qxe, Qxe, Qxe, Qxe, Qxe, Uue, Uue, Xue, Uue, Uue, Xue, Xue, Xue, Xue
Xue, Xue, Xue, Xue, Uue, Uue, Uue^Dr, Uue, Uue, Uue, Uue, Qxe, Qxe, Qxe, Qxe, Qxe^Zcla, Qxe, Qxe^Zclb, Qxe, Qxe^Tphz, Qxe^Tphz, Dd^Tphz, Qxe, Dd^Tphz, Qxe^Tphz, Qxe^Tphz, Qxe, Qxe, Qxe, Qxe, Qxe, Qxe, Qxe, Qxe, Qxe, Qxe, Uue, Uue, Uue, Uue, Uue, Uue, Xue, Xue, Xue, Xue
Xue, Xue, Xue, Xue, Uue, Uue, Uue, Uue, Uue, Uue, Uue, Qxe, Qxe, Qxe, Qxe, Qxe, Qxe, Qxe, Qxe, Qxe^Tphz, Qxe^Tphz, Qxe^Tphz, Qxe, Qxe^Tphz, Qxe^Tphz, Qxe^Tphz, Qxe, Qxe, Qxe, Qxe, Qxe, Qxe, Qxe, Qxe, Qxe, Qxe, Uue, Uue, Uue, Uue, Uue, Uue, Xue, Xue, Xue, Xue
Xue, Xue, Xue, Uue, Uue, Uue, Uue, Uue, Uue, Uue, Uue, Uue, Uue, Qxe, Qxe, Qxe, Qxe, Qxe, Qxe, Qxe, Qxe, Qxe, Rb, Qxe, Qxe, Qxe, Qxe, Qxe, Qxe, Qxe, Qxe, Qxe, Qxe, Qxe, Uue, Uue, Uue, Uue, Uue, Uue, Uue, Uue, Xue, Xue, Xue, Xue
Uue, Xue, Xue, Xue, Xue, Xue, Xue, Uue, Uue, Uue, Uue, Uue, Uue, Uue, Uue, Qxe, Uue, Qxe, Qxe, Qxe, Qxe, Rb, Rb, Rb, Uue, Rb, Uue, Qxe, Uue, Qxe, Qxe, Qxe, Qxe, Qxe, Uue, Uue, Uue, Uue, Uue^Dr, Uue, Uue, Uue, Xue, Xue, Xue, Xue
Xue, Uue, Uue, Uue, Uue, Xue, Uue, Uue, Uue, Uue, Uue, Uue, Uue, Uue, Uue, Uue, Rb, Rb, Uue, Qxe, Uue, Uue, Rb, Uue, Uue^Dr, Rb, Uue, Uue, Uue, Uue, Uue, Qxe, Uue, Uue, Uue, Uue, Uue, Uue, Uue, Uue, Uue, Uue, Xue, Xue, Xue, Xue
Xue, Xue, Xue, Uue, Uue, Uue, Uue, Uue, Uue^Es, Uue, Uue, Uue, Uue^Dr, Uue, Uue, Uue, Rb, Rb, Uue, Uue, Uue, Uue, Rb, Uue, Uue, Rb, Uue, Uue, Uue, Uue, Uue, Uue, Uue, Uue, Uue, Uue, Uue, Uue, Uue, Uue, Xue, Xue, Xue, Xue, Xue, Xue
Xue, Xue, Xue, Xue, Xue, Uue, Uue, Uue, Uue, Uue^Esd, Uue, Uue, Uue, Uue, Uue, Uue, Uue, Rb, Uue, Uue, Uue, Uue, Rb, Rb, Rb, Rb, Uue, Uue, Uue, Uue, Hhd, Uue, Uue^Dr, Uue, Uue, Uue, Uue, Uue, Uue, Uue, Xue, Xue, Xue, Xue, Xue, Xue
Xue, Xue, Xue, Uue, Uue, Xue, Uue, Uue, Uue, Uue, Uue, Uue, Rb, Uue, Rb, Rb, Rb, Rb, Uue, Uue, Rb, Rb, Uue, Rb, Rb, Uue, Uue, Uue, Uue, Hhd, Hhd, Uue, Uue, Uue, Uue, Uue, Uue, Uue, Xue, Uue, Xue, Xue, Xue, Xue, Xue, Xue
Xue, Xue, Xue, Uue, Uue, Uue, Uue, Uue, Uue, Uue, Uue, Rb, Rb, Rb, Uue, Uue, Uue, Uue, Uue, Rb, Uue, Uue, Uue^Dr, Uue, Uue, Rb, Rb, Uue, Uue, Uue, Uue, Uue, Uue, Uue, Uue, Uue, Xue, Xue, Xue, Xue, Uue, Uue, Xue, Xue, Xue, Xue
Xue, Xue, Uue, Uue, Uue, Uue, Uue, Uue, Uue^Dr, Uue, Uue, Rb, Uue, Uue, Uue, Uue, Uue^Es, Uue, Uue, Rb, Rb, Uue, Uue, Uue, Uue, Uue, Rb, Rb, Rb, Uue, Uue, Uue, Uue, Uue, Uue, Xue, Wog, Xue, Wog, Wwg, Uue, Uue, Uue, Xue, Xue, Xue
Xue, Xue, Uue, Uue, Uue, Hhd, Uue, Uue, Uue, Uue, Wwg, Rb, Rb, Uue, Uue, Uue, Uue, Uue, Uue, Rb, Rb, Uue, Uue, Uue, Uue, Uue, Uue, Rb, Rb, Uue, Uue, Uue, Uue, Uue, Uue, Wwg, Wwg, Wog, Wwg, Wwg, Uue, Uue, Xue, Xue, Xue, Xue
Xue, Xue, Uue, Uue, Uue, Uue, Uue, Uue^Es, Wwg, Wwg, Wwg, Wwg, Rb, Rb, Uue, Uue, Uue, Uue, Uue, Uue, Cty, Rb, Uue, Uue, Uue, Uue, Uue, Uue, Uue, Rb, Rb, Uue, Uue, Uue, Uue, Uue, Uue, Wwg, Wwg, Uue, Uue, Uue, Xue, Xue, Xue, Xue
Xue, Xue, Xue, Xue, Xue, Uue, Uue, Uue, Uue, Uue, Uue, Rb, Uue, Uue, Uue, Uue, Uue, Uue^Dr, Uue, Cty, Kty, Cty, Uue, Uue, Uue, Hhd, Uue, Uue, Uue, Uue, Uue, Rb, Rb, Uue, Uue, Uue, Uue, Uue^Dr, Uue, Uue, Uue, Uue, Uue, Xue, Xue, Xue
Xue, Xue, Xue, Xue, Xue, Xue, Xue, Uue, Uue, Uue^Esd, Uue, Uue, Uue, Uue, Uue, Uue^Esd, Uue^Vu, Uue, Uue, Cty, Cty, Cty, Uue, Uue, Uue^Vu, Uue, Uue, Uue, Uue, Uue, Uue, Uue, Uue, Rb, Rb, Uue, Uue, Uue, Uue, Uue^Es, Uue, Uue, Uue, Xue, Xue, Xue
Xue, Xue, Xue, Uue, Uue, Xue, Uue, Xue, Uue, Uue, Uue, Uue, Uue, Uue, Uue, Uue, Uue, Uue, Uue, Uue, Uue, Rb, Uue, Uue, Uue, Uue^Es, Wwg, Uue, Uue, Uue^Dr, Uue, Uue, Uue, Uue, Rb, Uue, Uue, Uue, Uue, Uue, Uue, Uue, Xue, Xue, Uue, Uue
Xue, Xue, Xue, Uue, Uue, Uue, Uue, Uue, Uue, Uue, Uue^Dr, Uue, Uue, Uue, Hhd, Hhd, Hhd, Uue, Uue^Vu, Uue, Uue, Rb, Rb, Uue, Uue, Wwg, Wwg, Wwg, Uue, Uue, Hhd, Uue, Uue, Uue, Uue, Rb, Uue, Uue, Uue, Uue, Xue, Xue, Uue, Uue, Xue, Xue
Xue, Xue, Wog, Wwg, Uue, Uue, Hhd, Uue, Uue, Uue, Uue, Uue, Uue, Uue, Uue, Hhd, Uue^Dr, Hhd, Uue, Uue, Uue, Uue, Rb, Uue, Uue, Uue, Uue, Uue, Uue, Hhd, Hhd, Hhd, Uue, Uue, Uue, Rb, Uue, Uue, Uue, Uue, Xue, Xue, Uue, Uue, Xue, Xue
Xue, Xue, Wwg, Wwg, Uue, Hhd, Hhd^Es, Hhd, Hhd, Uue, Uue, Uue, Uue, Uue, Uue, Uue, Uue, Uue, Uue, Uue, Uue, Uue, Rb, Uue, Uue, Uue, Uue, Uue^Dr, Uue, Uue, Uue, Uue, Uue, Uue, Uue, Rb, Uue, Uue, Uue, Uue, Xue, Uue, Uue, Xue, Xue, Xue
Xue, Xue, Xue, Uue, Uue, Uue, Uue, Hhd, Uue, Uue, Uue, Uue, Wwg, Uue, Uue, Uue, Uue, Uue, Uue^Esd, Uue^Es, Uue, Uue, Rb, Uue, Uue, Uue, Uue, Uue, Uue, Uue, Uue, Uue, Uue, Uue, Rb, Rb, Uue, Uue, Uue, Uue, Xue, Uue, Uue, Xue, Xue, Xue
Xue, Xue, Xue, Uue, Uue, Uue, Uue, Uue, Uue, Uue, Wwg, Wwg, Wog, Wwg, Wwg, Uue, Uue, Uue, Uue, Uue, Uue, Uue, Rb, Uue, Uue, Uue, Uue, Uue, Uue, Uue, Uue, Uue^Esd, Uue, Uue, Rb, Uue, Uue, Uue, Uue, Uue, Uue, Uue, Xue, Xue, Xue, Xue
Xue, Xue, Xue, Uue, Uue^Esd, Uue, Uue, Uue, Uue, Uue, Wwg, Wog, Wog, Wog, Wog, Wwg, Uue, Uue, Uue, Uue, Uue, Uue, Rb, Uue, Uue, Uue, Uue, Uue, Rb, Uue, Uue, Uue, Uue, Uue, Rb, Uue, Uue^Esd, Uue, Uue, Uue, Uue, Uue, Xue, Xue, Xue, Xue
Xue, Xue, Uue, Uue, Uue, Uue, Uue, Uue, Uue, Uue, Uue, Wwg, Wog, Wog, Wog, Wwg, Uue, Uue, Uue, Uue, Rb, Rb, Uue, Uue, Uue, Uue, Rb, Uue, Rb, Uue, Uue^Esd, Rb, Uue, Uue, Uue, Uue, Uue, Uue^Es, Uue, Uue, Uue, Uue, Xue, Xue, Xue, Xue
Xue, Xue, Xue, Uue, Uue, Uue, Uue, Uue, Uue, Uue, Uue, Wwg, Wwg, Wwg, Wwg, Wwg, Uue, Uue, Uue, Uue, Rb, Uue, Uue, Uue, Uue, Rb, Uue^Esd, Uue, Uue, Uue, Uue, Uue, Uue, Uue, Uue, Uue, Uue, Uue, Uue, Uue, Uue, Uue, Uue, Xue, Xue, Xue
Xue, Xue, Xue, Uue, Uue, Uue, Hhd, Uue, Re^Vct, Uue, Uue, Uue, Uue, Uue, Uue, Uue, Uue, Uue, Rb, Rb, Uue, Uue, Uue, Rb, Uue, Uue, Uue, Uue, Uue, Uue, Uue, Uue^Dr, Uue, Uue^Dr, Uue, Uue, Uue, Uue, Hhd, Hhd, Hhd, Uue, Uue, Xue, Xue, Xue
Xue, Xue, Xue, Uue, Uue, Uue, Hhd, Hhd, Hhd, Uue, Uue, Uue, Uue^Es, Uue, Uue, Uue, Rb, Rb, Rb, Rb, Uue, Uue, Uue, Uue, Uue^Es, Uue, Uue, Uue^Esd, Uue, Uue, Uue, Uue, Uue, Uue, Uue, Uue, Uue, Uue, Uue, Hhd, Uue, Uue, Uue, Xue, Xue, Xue
Xue, Xue, Xue, Uue, Uue, Uue, Re^Vct, Hhd^Es, Uue, Uue, Uue, Uue, Uue, Uue, Rb, Rb, Uue, Rb, Uue, Uue, Uue, Uue, Uue, Uue^Es, Uue, Uue, Uue, Uue, Uue, Uue^Es, Uue, Uue, Uue, Uue, Qxe, Uue, Uue, Uue, Uue, Uue, Uue, Uue, Uue, Xue, Xue, Xue
Xue, Xue, Xue, Uue, Uue, Uue^Dr, Uue, Uue, Ce, Uue, Rb, Rb, Rb, Rb, Uue, Re^Vct, Uue, Uue, Uue, Uue, Uue, Uue, Uue, Uue^Es, Uue, Uue, Uue, Uue, Uue, Uue, Uue, Uue, Uue, Qxe, Qxe, Qxe, Qxe, Uue, Uue, Uue^Es, Uue, Uue, Xue, Xue, Xue, Xue
Xue, Xue, Xue, Uue, Uue, Uue, Ce, Ce, Ke, Ce, Ce, Rb, Uue, Uue, Uue, Uue, Xue, Xue, Xue, Uue, Xue, Uue, Uue, Uue, Uue, Uue, Uue, Uue, Qxe, Qxe, Qxe, Qxe, Qxe, Qxe, Qxe, Qxe, Qxe, Uue, Uue, Uue, Xue, Xue, Xue, Xue, Xue, Xue
Xue, Xue, Xue, Xue, Xue, Uue, Rb, Rb, Rb, Rb, Uue, Uue, Xue, Uue, Xue, Xue, Xue, Xue, Xue, Xue, Xue, Xue, Xue, Xue, Xue, Uue, Qxe, Qxe, Qxe, Qxe, Qxe, Qxe, Qxe, Qxe, Qxe, Qxe, Qxe, Uue, Xue, Xue, Xue, Xue, Xue, Xue, Xue, Xue
Xue, Xue, Xue, Xue, Xue, Uue, Rb, Rb, Uue, Uue, Uue, Xue, Xue, Xue, Xue, Xue, Xue, Xue, Xue, Xue, Xue, Xue, Xue, Xue, Xue, Xue, Qxe, Qxe, Qxe, Qxe, Qxe, Qxe, Qxe, Qxe, Qxe, Qxe, Qxe, Xue, Xue, Xue, Xue, Xue, Xue, Xue, Xue, Xue
