border_size=1
usage=map

Dd^Tbny, Dd^Tbny, Dd^Tbny, Dd^Tbny, Dd^Tbny, Dd^Tbny, Dd^Tbny, Dd^Tbny, Hd^Tbny, Hd^Tbny, Dd^Tbny, Hd^Tbny, Hd^Tbny, Hd^Tbny, Hd^Tbny, Dd^Tbny, Dd^Tbny, Re, Aa, Aa, Ha, Ms, Ms, Ms, Spay, Spay, Spay, Ms, Ms, Ha, Ha, Aa, Re^Lydg, Dd, Dd^Rusy, Dd^Rusy, Dd, Dd, Dd^Rusy, Dd, Dd, Dd^Es, Dd, Qxe, Qxe, Qxe, Qxe, Qxe, Qxe, Qxe, Qxe, Qxe, Qxe, Qxe
Dd^Tbny, Dd^Tbny, Dd^Tbny, Dd^Tbny, Dd^Tbny, Dd^Tbny, Dd^Tbny, Dd^Tbny, Dd^Tbny, Dd^Tbny, Dd^Tbny, Hd^Tbny, Hd^Tbny, Hd^Tbny, Hd^Tbny, Dd^Tbny, Dd^Tbny, Re^Lydg, Re^Lydg, Aa, Aa, Ha, Ha, Ms, Ms, Spay, Ms, Ms, Ha, Ha, Aa, Aa, Re^Lydg, Dd, Dd^Rusy, Dd^Rusy, Dd^Rusy, Dd, Dd^Rusy, 3 Dd, Dd, Dd^Es, Qxe, Qxe, Qxe, Qxe, Qxe, Qxe, Qxe, Qxe, Qxe, Qxe, Qxe, Qxe
Dd^Tbny, Dd^Tbny, Dd^Tbny, Dd^Tbny, Dd^Tbny, Dd^Tbny, Dd^Tbny, Dd^Tbny, Dd^Tbny, Dd^Tbny, Dd^Tbny, Hd^Tbny, Hd^Tbny, Hd^Tbny, Hd^Tbny, Dd^Tbny, Dd^Tbny, Dd^Tbny, Dd, Re^Lydg, Re^Lydg, Aa, Aa, Ha, Ha, Spay, Ha, Ms, Ha, Aa, Re^Lydg, Re^Lydg, Dd, Dd, Dd^Rusy, Dd^Rusy, Dd^Rusy, Dd, Dd, Dd, Dd, Rd, Qxe, Qxe, Qxe, Qxe, Qxe, Qxe, Qxe, Qxe, Qxe, Qxe, Qxe, Qxe
Dd^Tbny, Dd^Tbny, Dd^Tbny, Dd^Tbny, Dd^Tbny, Dd^Tbny, Dd^Tbny, Dd^Tbny, Hd^Tbny, Dd^Tbny, Dd^Tbny, Hd^Tbny, Hd^Tbny, Hd^Tbny, Hd^Tbny, Dd^Tbny, Dd^Tbny, Dd^Tbny, Dd, Dd^Rusy, Dd^Rusy, Re^Lydg, Re^Lydg, Aa, Aa, Spay, Ha, Ha, Aa, Aa, Re^Lydg, Dd^Rusy, Dd^Ruty, Dd^Rusy, Dd^Rusy, Dd^Rusy, Dd^Rusy, Dd^Rusy, Dd^Rusy, Dd, Dd, Dd, Rd, Qxe, Qxe, Qxe, Qxe, Qxe, Qxe, Qxe, Qxe, Qxe, Qxe, Qxe
Dd^Tbny, Dd^Tbny, Dd^Tbny, Dd^Tbny, Dd^Tbny, Dd^Tbny, Dd^Tbny, Dd^Tbny, Hd^Tbny, Hd^Tbny, Dd, Hd^Tbny, Dd^Rusy, Dd^Rusy, Hd^Tbny, Dd^Tbny, Dd^Tbny, Dd^Tbny, Dd^Rusy, Dd^Rusy, Dd^Rusy, Dd^Rusy, Re^Lydg, Aa, Aa, Spay, Aa, Ha, Aa, Aa, Re^Lydg, Dd^Rusy, Dd^Rusy, Dd^Ruty, Dd^Rusy, Dd^Rusy, Dd^Rusy, Dd, Dd^Rusy, Dd, Dd^Rusy, Dd, Dd, Qxe, Qxe, Qxe, Qxe, Qxe, Qxe, Qxe, Qxe, Qxe, Qxe, Qxe
Dd^Tbny, Dd^Tbny, Dd^Tbny, Dd^Tbny, Dd^Tbny, Dd^Tbny, Dd^Tbny, Dd^Tbny, Hd^Tbny, Hd^Tbny, Dd^Rusy, Dd^Rusy, Dd^Rusy, Dd^Rusy, Dd^Rusy, Dd^Rusy, Dd^Rusy, Dd^Rusy, Dd, Dd^Rusy, Dd^Rusy, Dd^Rusy, Dd^Rusy, Re^Lydg, Re^Lydg, Aa, Aa, Aa, Re^Lydg, Re^Lydg, Dd^Rusy, Dd^Rusy, Dd^Rusy, Dd^Rusy, Dd^Rusy, Dd^Rusy, Dd^Rusy, Dd^Rusy, Dd^Rusy, Dd^Rusy, Dd, Dd^Rusy, Dd, Qxe, Qxe, Qxe, Qxe, Qxe, Qxe, Qxe, Qxe, Qxe, Qxe, Qxe
Dd^Tbny, Dd^Tbny, Dd^Tbny, Dd^Tbny, Dd^Tbny, Dd^Tbny, Dd^Tbny, Dd^Tbny, Hd^Tbny, Dd^Rusy, Dd^Rusy, Dd^Rusy, Hd^Tbny, Dd^Rusy, Dd^Rusy, Dd^Rusy, Dd^Rusy, Dd^Rusy, Dd, Dd^Rusy, Dd^Rusy, Dd^Rusy, Dd^Rusy, Dd^Rusy, Dd^Rusy, Re^Lydg, Re, Aa, 2 Re, Re, Dd^Rusy, Dd^Rusy, Dd, Dd^Rusy, Dd^Rusy, Dd^Rusy, Dd^Rusy, Dd^Rusy, Dd^Rusy, Dd, Dd, Dd, Dd, Qxe, Qxe, Qxe, Qxe, Qxe, Qxe, Qxe, Qxe, Qxe, Dd, Dd^Rusy
Dd^Tbny, Dd^Tbny, Dd^Tbny, Dd^Tbny, Dd^Tbny, Dd^Tbny, Dd^Tbny, Dd^Tbny, Hd^Tbny, Hd^Tbny, Dd^Tbny, Hd^Tbny, Hd^Tbny, Hd^Tbny, Hd^Tbny, Dd^Rusy, Dd^Tbny, Dd^Tbny, Dd, Dd^Rusy, Dd^Rusy, Dd^Rusy, Dd^Ruty, Dd^Rusy, Dd^Rusy, Dd, Dd, Re, Dd^Rusy, Dd, Dd^Rusy, Dd, Dd, Dd, Dd^Rusy, Dd^Rusy, Dd^Rusy, Dd^Rusy, Dd^Rusy, Dd^Rusy, Dd^Rusy, Dd, Dd, Dd, Rd, Qxe, Qxe, Qxe, Qxe, Qxe, Dd, Dd, Dd^Rusy, Dd^Rusy
Dd^Tbny, Dd^Tbny, Dd^Tbny, Dd^Tbny, Dd^Tbny, Dd^Tbny, Dd^Tbny, Dd^Tbny, Chr, Hd^Tbny, Dd^Tbny, Hd^Tbny, Hd^Tbny, Hd^Tbny, Hd^Tbny, Dd^Tbny, Dd^Tbny, Dd^Tbny, Dd, Dd^Rusy, Dd^Rusy, Dd^Rusy, Dd^Rusy, Dd^Ruty, Dd^Rusy, Dd, Dd, Dd^Rusy, Dd^Rusy, Dd, Dd^Ruty, Dd, Dd^Ruty, Dd^Zcla, Dd^Zclb, Dd^Rusy, Dd^Rusy, Dd^Rusy, Dd^Rusy, Dd^Rusy, Dd^Rusy, Dd^Es, Dd, Dd, Dd^Rusy, Dd, Dd, Qxe, Rd, Dd, Dd^Rusy, Dd, Dd^Rusy, Dd^Rusy
Dd^Tbny, Dd^Tbny, Dd^Tbny, Dd^Tbny, Dd^Tbny, Dd^Tbny, Dd^Tbny, Chr, 5 Khr, Chr, Dd^Tbny, Hd^Tbny, Hd^Tbny, Hd^Tbny, Hd^Tbny, Dd^Tbny, Dd^Tbny, Dd^Tbny, Dd, Dd^Rusy, Dd^Rusy, Dd^Rusy, Dd^Rusy, Dd^Rusy, Dd^Rusy, Dd, Dd^Ruty, Dd^Rusy, Dd^Rusy, Dd, Dd^Rusy, Dd^Ruty, Dd, Dd, Dd^Rusy, Dd^Ruty, Dd^Rusy, Dd^Rusy, Dd^Rusy, Dd, Dd^Rusy, Dd^Rusy, Dd, Dd^Rusy, Dd^Rusy, Dd, Dd, Dd, Dd, Dd, Dd^Rusy, Dd, Dd^Rusy, Dd^Rusy
Dd^Tbny, Dd^Tbny, Dd^Tbny, Dd^Tbny, Dd^Tbny, Dd^Tbny, Dd^Tbny, Chr, Chr, Chr, Dd^Tbny, Hd^Tbny, Hd^Tbny, Hd^Tbny, Hd^Tbny, Dd^Tbny, Dd^Tbny, Dd^Tbny, Dd^Ruty, Dd^Rusy, Dd^Rusy, Dd^Rusy, Dd^Rusy, Dd^Rusy, Dd^Rusy, Dd, Dd, Dd^Rusy, Dd^Rusy, Dd, Dd^Rusy, Dd, Dd^Zcla, Dd^Zclb, Dd^Rusy, Dd^Rusy, Dd^Rusy, Dd^Rusy, Dd^Rusy, Dd, Dd, Dd^Es, Dd, Dd^Rusy, Dd^Rryn, Dd^Rusy, Dd^Rusy, Rd, Dd, Dd, Dd^Rusy, Dd, Dd^Rusy, Dd^Rusy
Dd^Tbny, Dd^Tbny, Dd^Tbny, Dd^Tbny, Dd^Tbny, Dd^Tbny, Dd^Tbny, Dd^Tbny, Hd^Tbny, Hd^Tbny, Dd^Tbny, Hd^Tbny, Hd^Tbny, Hd^Tbny, Hd^Tbny, Dd^Tbny, Dd^Tbny, Dd^Tbny, Dd, Dd^Rusy, Dd^Rusy, Dd^Rusy, Dd^Rusy, Dd^Rusy, Dd^Rusy, Dd, Dd, Dd^Rusy, Dd^Rusy, Dd, Dd^Rusy, Dd, Dd, Dd, Dd^Rusy, Dd^Rusy, Dd^Rusy, Dd^Rusy, Dd^Rusy, Dd, Dd, Dd^Es, Dd, Dd^Rusy, Dd^Rusy, Dd^Rusy, Dd, Dd, Dd^Rusy, Dd, Dd^Rusy, Dd, Dd^Rusy, Dd^Rusy
Dd^Tbny, Dd^Tbny, Dd^Tbny, Dd^Tbny, Dd^Tbny, Dd^Tbny, Dd^Tbny, Dd^Tbny, Dd^Tbny, Rd^Tbny, Dd^Tbny, Chr, Dd^Tbny, Dd^Tbny, Dd^Tbny, Dd^Tbny, Dd^Tbny, Dd^Tbny, Dd, Dd, Dd^Rusy, Dd^Rusy, Dd, Dd^Rusy, Dd^Rusy, Dd, Dd, Dd^Zcla, Dd^Rusy, Dd^Zclb, Dd^Ruty, Dd^Rusy, Dd^Rusy, Dd^Rusy, Dd^Rusy, Dd^Rusy, Dd^Rusy, Dd^Rusy, Dd^Rusy, Dd, Dd, Dd^Es, Dd, Dd^Es, Dd^Es, Dd, 4 Ke, Dd^Rusy, Dd, Dd, Dd^Rusy, Dd, Dd^Es, Dd
Dd^Tbny, Dd^Tbny, Dd^Tbny, Dd^Tbny, Dd^Tbny, Dd^Tbny, Dd^Vhcr, Dd^Tbny, Dd^Tbny, Rd^Tbny, Rd^Tbny, Rd^Tbny, Dd^Tbny, Dd^Tbny, Rd^Tbny, Uue^Tbny, Uue^Tbny, Uue^Fyok, Uue, Uue, Dd^Ruty, Dd^Rusy, Dd^Rusy, Dd^Es, Dd^Rusy, Dd^Rusy, Dd^Rusy, Dd^Rusy, Dd^Ruty, Dd, Dd, Dd^Zcla, Dd^Ruty, Dd^Rusy, Dd^Es, Dd^Rusy, Dd^Rusy, Dd^Rusy, Dd^Rusy, Dd, Dd, Dd^Es, Dd^Es, Dd, Rd^Es, Ce, Ce, Ce, Ce, Dd, Dd^Es, Dd^Rusy, Dd, Dd
Dd^Tbny, Dd^Tbny, Dd^Tbny, Dd^Tbny, Dd^Tbny, Dd^Tbny, Dd^Tbny, Dd^Tbny, Dd^Tbny, Dd^Tbny, Dd^Tbny, Dd^Tbny, Rd^Tbny, Rd^Tbny, Rd^Tbny, Rd^Tbny, Uue^Tbny, Uue^Tbny, Uue, Uue, Dd^Rusy, Uue, Dd^Rusy, Dd^Rusy, Dd^Rusy, Dd^Ruty, Dd^Rusy, Dd^Rusy, Dd^Rusy, Dd, Dd^Rusy, Dd^Rusy, Dd^Rusy, Dd^Rusy, Dd^Es, Dd^Es, Dd^Es, Dd^Rusy, Dd^Rusy, Dd^Ruty, Dd, Dd^Es, Dd, Dd^Es, Dd^Es, Ce, Rd, Dd, Dd^Rusy, Dd, Dd^Es, Dd, Dd^Es, Dd
Rd^Tbny, Rd^Tbny, Rd^Tbny, Rd^Tbny, Rd^Tbny, Rd^Tbny, Rd^Tbny, Dd^Tbny, Rd^Tbny, Dd^Tbny, Rd^Tbny, Rd^Tbny, Uue^Tbny, Uue^Tbny, Uue^Tbny, Uue^Tbny, Uue^Tbny, Uue, Dd, Dd^Rusy, Dd^Rusy, Dd^Rusy, Dd^Ruty, Dd^Rusy, Dd^Rusy, Dd^Rusy, Dd^Rusy, Dd^Rusy, Dd^Rusy, Dd^Rusy, Dd^Ruty, Dd, Dd, Dd^Rusy, Dd^Rusy, Dd, Dd^Es, Dd^Es, Dd^Rusy, Dd, Dd^Es, Dd, Dd^Es, Dd^Rusy, Dd, Dd^Es, Rd, Dd^Rusy, Dd^Rusy, Dd, Dd^Rusy, Dd^Es, Dd, Dd
Rd^Tbny, Rd^Tbny, Rb^Tbny, Rb^Tbny, Rb^Tbny, Rb^Fyok, Rd^Tbny, Rd^Tbny, Rd^Tbny, Rd^Tbny, Rd^Tbny, Uue^Tbny, Qxe, Qxe, Qxe, Uue, Uue, Uue, Dd^Rusy, Dd^Ruty, Dd^Ruty, Dd^Ruty, Dd^Rusy, Dd^Rusy, Dd^Rusy, Dd^Rusy, Dd^Rusy, Dd^Ruty, Dd^Rusy, Dd^Rusy, Dd^Rusy, Dd^Ruty, Dd, Dd^Rusy, Dd^Ruty, Dd, Dd, Dd, Dd^Es, Dd^Rusy, Dd^Es, Dd^Es, Dd^Es, Dd^Es, Rd, Dd, Dd, Dd^Rusy, Dd^Rusy, Dd^Rusy, Dd, Dd, Dd, Dd
Rd^Tbny, Rd^Tbny, Rd^Tbny, Rd^Tbny, Rd^Tbny, Rb^Tbny, Rd^Tbny, Rd^Tbny, Dd, Rd^Tbny, Rd, Uue^Tbny, Uue, Qxe, Uue, Uue, Uue, Rd, Rd, Dd, Dd^Rusy, Dd^Rusy, Re^Rusy, Rd^Rusy, Dd^Rusy, Dd^Rusy, Dd^Rusy, Rd^Rusy, Rd^Rusy, Dd^Rusy, Re^Rusy, Dd^Rusy, Dd, Dd^Rusy, Dd^Ecf, Dd, Dd^Ruty, Dd, Dd^Ruty, Dd^Es, Dd^Es, Dd^Es, Dd, Dd, Dd^Rusy, Dd, Dd^Dc, Dd, Dd^Es, Dd, Dd, Hd, Dd, Dd
Dd, Dd, Dd, Dd, Dd, Rd^Tbny, Dd, Dd, Hd^Vhhr, Dd, Dd, Rd, Rd, Rd, Rd^Es, Uue, Uue^Rusy, Uue, Uue^Es, Rd, Rd, Dd^Rusy, Rd^Rusy, Re^Rusy, Uue^Rusy, Re^Rusy, Uue^Rusy, Uue^Rusy, Uue^Rusy, Re^Rusy, Dd^Rusy, Dd^Rusy, Dd^Rusy, Dd^Rusy, Dd^Rusy, Dd, Dd, Dd^Ruty, Dd, Dd^Es, Dd, Dd^Es, Dd, Rd, Rd, Dd, Dd^Dr, Dd, Dd^Es, Dd, Dd, Dd^Rusy, Dd, Dd
Dd, Dd, Dd, Dd, Dd, Dd, Dd, Hd, Hd, Hd, Dd, Dd, Uue, Uue, Uue, Uue, Uue^Es, Uue, Uue^Es, Uue, Uue, Rd, Uue^Rusy, Uue^Rusy, Uue, Uue^Rusy, Uue, Uue^Rusy, Uue, Dd^Rusy, Uue^Rusy, Dd, Dd^Rusy, Dd, Dd^Rusy, Dd, Dd^Rusy, Dd^Es, Dd, Dd, Hd, Dd^Es, Dd, Rd, Rd, Rd, Dd, Dd, Dd^Eff, Dd^Eff, Dd^Es, Dd^Es, Dd^Eff, Dd^Eff
Rd, Rd, Rd, Rd, Rd^Es, Dd^Es, Dd, Dd, Dd, Dd, Dd, Rd^Es, Rd, Uue^Es, Rd, Uue^Es, Rd^Es, Rd, Rd, Rd, Rd, Uue, Uue, Uue^Rusy, Uue, Uue, Re, Uue, Re^Es, Uue, Uue, Uue, Dd^Rusy, Dd^Rusy, Dd^Rusy, Dd, Dd^Rusy, Dd, Dd^Dc, Dd, Dd^Rusy, Dd, Dd^Rusy, Dd^Rusy, Dd, Dd^Es, Dd^Eff, Dd^Eff, Dd^Dc, Dd, Dd, Dd, Dd^Es, Dd
Re^Es, Re, Re^Es, Rd, Rd, Rd, Dd, Dd^Dc, Dd, Dd, Dd^Es, Dd^Es, Dd, Rd, Dd, Rd, Dd^Es, Dd, Dd^Dr, Dd, Rd, Uue, Uue, Uue, Uue, Re, Re^Es, Re, Re, Re, Uue, Uue, Rd, Dd^Rusy, Dd^Rusy, Dd, Dd^Es, Dd, Dd^Es, Dd, Dd^Es, Dd, Dd, Rd, Dd, Dd^Eff, Dd^Vhr, Dd, Dd, Dd, Dd, Dd, Dd, Dd
Uue, Uue^Es, Uue^Es, Uue^Es, Uue, Rd, Rd, Rd, Rd, Dd, Dd^Es, Dd^Es, Dd, Dd, Hd, Dd^Es, Dd^Es, Dd^Es, Dd, Dd^Es, Dd, Rd^Rusy, Uue, Uue, Uue, Uue, Uue, Re, Uue, Uue, Rd^Es, Rd, Dd^Rusy, Dd, Dd^Rusy, Dd^Rusy, Dd^Rusy, Dd^Es, Rd^Es, Dd, Dd, Dd, Dd^Dc, Dd, Rd, Rd, Rd, Dd, Dd^Es, Dd, Dd^Es, Dd, Dd, Dd
Rb^Fdy, Rb^Fdy, Rb^Fdy, Rb^Fdy, Rb^Fdy, Uue, Uue, Re, Uue, Rd^Es, Rd^Es, Dd^Es, Hd, Dd, Hd, Hd^Es, Hd, Dd, Dd, Hd, Dd^Es, Rd, Rd, Uue, Re, Uue^Fyok, Re, Re, Uue, Uue, Rd, Dd, Dd, Dd^Rusy, Dd^Rusy, Dd^Rusy, Dd^Es, Dd^Es, Dd, Rd, Rd, Dd, Dd, Rd, Dd, Dd, Rd, Dd, Dd, Dd, Dd, Dd, Dd^Rusy, Dd
Rb^Fdy, Rb^Fdy, Rb^Fdy, Rb^Fdy, Rb^Fdy, Rb^Fdy, Rb^Fdy, Uue, Rb^Fdy, Uue^Es, Uue^Es, Rd, Dd, Hd, Hd, Hd, Dd, Dd^Es, Dd, Dd, Dd, Dd, Rd, Uue, Uue, Re, Uue, Uue, Rd, Rd, Rd^Dr, Dd, Dd^Es, Dd^Es, Dd^Es, Dd, Dd^Es, Dd, Dd, Dd, Rd, Dd, Dd^Rusy, Dd^Rusy, Dd, Dd, Dd, Rd, Dd, Dd, Dd, Dd^Rusy, Dd^Rusy, Dd^Rusy
Rb^Fdy, Rb^Fdy, Rb^Fdy, Rb^Fdy, Rb^Fdy, Rb^Fdy, Rb^Fdy, Rb^Fyok, Rb^Fdy, Rb^Fdy, Uue, Rd, Rd, Dd^Es, Dd^Es, Dd^Rusy, Dd, Dd^Es, Dd, Dd, Rd, Rd, Uue, Uue, Uue, Uue, Uue, Uue, Uue, Rd, Uue, Rd, Dd, Dd^Es, Dd^Es, Dd, Dd, Dd, Dd^Es, Dd, Dd, Dd, Dd, Dd, Dd, Dd^Dc, Dd, Rd, Dd, Dd^Dr, Dd, Dd, Dd, Dd
Rb^Fdy, Rb^Fdy, Rb^Fdy, Rb^Fdy, Rb^Fdy, Rb^Fdy, Rb^Fdy, Rb^Fdy, Rb^Fdy, Uue, Rb^Fdy, Uue, Uue, Rd, Rd, Dd, Dd, Dd^Dc, Dd, Rd, Uue, Uue, Qxe, Uue, Uue, Uue, Uue^Es, Uue, Uue, Uue, Rd, Rd, Dd, Dd, Dd, Dd, Dd, Dd^Esd, Rd, Dd^Esd, Dd^Esd, Dd^Esd, Hd, Dd^Esd, Dd, Dd, Dd, Rd, Dd, Dd, Dd, Dd, Dd, Dd
Uue, Uue, Uue, Uue^Zcla, Uue^Zclb, Rb^Fdy, Qxe^Zcla, Qxe, Qxe, Qxe, Qxe, Qxe, Qxe, Uue, Uue^Tbny, Rd, Dd^Tbny, Dd, Dd, Rd, Rd, Uue, Uue, Qxe, Qxe, Qxe, Qxe, Qxe, Uue, Rd, Dd, Dd, Dd, Dd, Dd, Dd, Rd, Rd, Uue, Rd, Rd, Dd, Dd, Hd, Hd, Hd, Dd, Rd, Rd, Dd, Dd^Es, Dd, Dd, Dd
Re, Uue, Re^Es, Uue, Uue, Uue, Uue, Qxe, Qxe, Qxe, Qxe, Qxe, Qxe, Uue, Uue, Rd^Tbny, Rd^Tbny, Rd^Tbny, Rd, Dd^Tbny, Dd, Rd, Rd, Uue, Uue, Uue, Uue, Uue, Rd, Rd^Es, Dd, Dd, Dd, Dd^Es, Dd, Dd, Rd, Uue, Qxe, Uue, Rd, Dd, Hd, Hd, Hd, Hd, Hd, Dd, Dd, Dd, Dd, Dd, Dd, Dd^Es
Rd, Rd, Rd, Rd, Rd, Uue^Es, Uue, Uue, Uue, Qxe, Uue, Qxe, Uue, Qxe, Qxe, Uue, Uue^Tbny, Rd^Tbny, Uue^Fyok, Rd, Uue, Chr, Uue, Uue, Uue, Uue, Rd, Rd, Dd, Dd, Dd, Dd^Dr, Dd, Dd, Dd^Es, Dd, Rd, Uue, Uue, Uue, Rd, Rd, Rd, Dd, Hd, Hd, Hd, Dd, Dd, Rd, Dd, Dd, Dd, Dd
Rd, Rd, Rd, Rd, Rd, Rd, Rd, Uue, Re, Uue, Uue, Uue, Uue, Qxe, Uue^Tbny, Uue^Tbny, Uue^Tbny, Uue, Uue^Tbny, Uue^Tbny, Uue, Re, Re, Re^Vhcr, Uue, Rd^Es, Rd, Dd, Dd^Es, Dd, Dd, Dd, Dd, Dd^Dc, Dd, Rd, Rd, Uue, Rd, Rd, Dd, Dd, Rd, Dd, Dd, Dd, Dd, Dd, Rd, Rd, Dd, Hd, Hd, Dd
Dd, Dd, Dd, Dd, Dd^Es, Rd, Dd, Rd, Rd, Re^Es, Re, Uue, Uue^Zcla, Uue, Uue^Zcla, Uue^Tbny, Qxe, Uue^Tbny, Qxe, Uue^Tbny, Qxe, Chr, Uue, Uue, Uue, Uue, Rd, Rd, Dd, Dd, Dd, Dd, Dd, Dd, Dd, Dd, Rd, Rd, Dd, Dd, Dd^Dc, Dd, Dd, Rd, Rd, Dd, Dd, Rd, Rd, Rd, Dd, Hd, Hd, Hd
Dd, Dd, Dd, Dd, Dd, Dd, Dd, Dd, Dd, Rd, Re, Re^Es, Re, Uue, Uue, Uue^Zclb, Qxe^Zcla, Qxe, Re, Qxe, Qxe, Qxe, Qxe, Uue, Uue, Rd, Rd^Dr, Dd, Dd, Dd^Es, Dd, Dd, Hd, Dd, Hd, Dd, Rd, Dd, Dd, Dd, Dd^Es, Dd, Dd, Rd, Dd, Dd, Dd, Dd, Dd, Dd, Dd, Dd, Hd, Hd
Rd, Rd, Dd, Dd, Dd, Dd, Dd, Dd, Dd, Rd, Rd, Re, Re, Re^Tbny, Re, Uue, Uue, Qxe, Re, Chr, Khr, Chr, Chr, Qxe, Qxe^Zcla, Uue^Zclb, Uue^Zcla, Rd, Dd, Dd, Dd, Hd, Dd, Hd, Dd, Hd, Dd, Rd, Rd, Dd, Dd, Dd, Dd, Dd, Dd, Dd, Dd, Dd, Dd, Rd, Dd, Dd, Dd, Hd
Re, Rd, Rd, Dd, Dd, Dd, Dd, Dd^Es, Dd, Dd, Dd, Rd, Rd, Rd, Re, Uue, Uue, Re, Uue, Qxe, Uue, Chr, Uue, Qxe^Zclb, Uue, Uue, Uue, Rd, Rd, Rd^Vhr, Dd, Dd, Dd^Es, Dd, Dd, Hd, Dd, Dd^Es, Dd^Es, Rd, Dd, Dd, Dd^Eff, Dd^Eff, Dd, Dd, Dd, Dd, Ce, Dd, Dd, Dd, Dd, Dd
Re, Re, Re, Rd, Rd, Dd, Dd, Dd, Dd, Dd, Dd^Es, Dd, Dd, Rd, Rd, Re, Re^Es, Re, Re, Uue, Uue, Re, Re, Uue, Uue, Uue, Uue, Rd, Dd, Rd, Dd, Dd, Dd, Dd, Dd, Dd, Dd, Dd, Dd, Rd, Dd, Dd^Es, Rd, Dd^Eff, Dd^Eff, Dd, Dd, Dd, Dd, Dd, Dd, Dd, Dd, Dd
Re, Re, Re^Eff, Re^Eff, Re^Eff, Rd, Rd, Rd^Es, Rd, Rd, Rd, Dd, Rd, Rd^Es, Rd, Rd, Rd, Rd, Rd, Uue, Rd, Uue, Re, Uue, Re, Uue, Re, Rd, Rd, Dd, Dd, Dd, Dd, Rd, Rd, Rd, Rd, Rd, Rd, Rd, Rd, Rd, Re, Rd, Rd, Dd^Eff, Dd^Eff, Dd, Dd^Vhr, Dd, Dd, Dd, Dd, Dd
Rb, Rb^Eff, Rb, Rb^Vhr, Rb^Tshy, Re, Re, Re, Re, Rd, Rd, Rd, Rd, Rd, Rd, Rd, Dd, Rd, Rd^Es, Rd, Rd, Re, Re, Re, Rd, Re, Re^Es, Re, Rd, Dd^Es, Dd, Dd, Dd, Dd, Dd, Rd, Rd, Re, Re, Re, Gd, Re, Gd^Tshy, Re, Re, Rd, Dd, Dd^Eff, Dd, Dd, Dd, Dd, Dd^Eff, Dd^Eff
Rb^Tshy, Rb^Tshy, Rb^Tshy, Rb^Tshy, Rb^Tshy, Rb^Tshy, Rb, Re, Re, Re, Re^Es, Rd^Es, Rd, Rd, Dd, Dd, Hd, Dd^Es, Rd, Rd, Rd^Es, Rd^Dr, Rd, Rd, Dd, Re, Rd, Rd, Dd, Dd, Dd, Dd, Dd, Hd, Hd, Dd, Rd, Re, Re, Re, Re^Tshy, Gd^Tshy, Gd^Tshy, Gd^Tshy, Re^Tshy, Rd, Rd, Dd, Dd, Dd, Dd, Dd^Eff, Dd, Dd
Re, Rb^Tshy, Rb^Tshy, Rb^Tshy, Rb^Tshy, Rb^Tshy, Rb, Rb^Fdy, Gll^Fp, Re, Re, Rd, Rd, Rd, Rd, Dd, Dd, Dd, Rd, Rd, Rd, Rd, Dd, Dd, Dd, Rd, Rd, Dd, Dd, Dd, Hd, Hd, Hd, Hd, Hd, Dd, Rd, Rd, Rd, Rd, Rd, Re, Re, Gd, Rd, Rd, Rd, Dd, Dd, Dd, Rd, Dd, Dd, Dd
Re, Re, Re^Es, Rb, Rb, Rb, Rb, Rb^Fdy, Rb^Fdy, Rb^Fdy, Rb^Fdy, Re^Es, Re, Rd, Rd, Dd, Dd, Dd, Rd, Rd, Re, Rd, Rd, Rd^Es, Rd, Dd, Rd, Rd, Dd, Dd, Dd, Dd, Dd, Dd, Dd, Dd^Es, Dd^Es, Dd, Dd, Dd, Dd, Rd, Rd, Rd, Rd, Rd, Dd^Es, Rd, Rd, Rd, Dd, Dd, 7 Rd, Dd
Rb, Re, Re, Re, Rb^Es, Rb, Rb^Es, Rb, Rb, Rb^Fyok, Rb, Rb, Re, Re, Rd, Rd, Dd, Rd, Rd, Re, Re, Re, Re, Rd, Re, Rd, Rd, Rd, Dd, Dd^Es, Dd, Dd, Dd, Dd, Dd, Dd, Dd, Dd, Hd, Hd, Dd, Rd, Rd, Rd, Dd, Dd, Dd, Dd, Dd, Dd, Dd, Rd, Rd, Rd
Rd, Rd, Rd, Re, Re^Es, Rb, Re, Re, Re, Rb, Re, Re, Rd, Rd, Rd^Es, Dd, Dd, Dd, Dd, Rd, Rd^Es, Re, Re, Re, Rd, Rd, Rd, Rd, Dd, Dd, Dd, Dd, Dd, Dd^Fdy, Dd^Fdy, Dd^Fdy, Dd, Hd, Dd, Dd, Dd, Rd, Rd, Dd, Rd, Dd, Dd, Dd, Dd, Dd, Dd, Dd, Dd, Rd
Dd, 6 Dd, Rd, Rd, Rd, Re, Rd, Re, Rd, Re, Rd, Rd, Rd, Rd, Dd, Dd, Hd, Dd, Dd, Dd, Dd, Rd, Rd, Re, Rd, Rd^Es, Rd, Rd, Rd, Dd, Dd, Dd, Dd, Dd, Dd^Fdy, Dd, Dd, Dd, Rd, Rd, Dd, Rd, Dd, Rd, Dd, Rd, Rd, Dd, Dd, Dd, Dd, Dd, Dd, Dd
Dd, Dd, Dd, Rd, Rd, Rd, Rd, Rd, Dd, Rd, Dd, Rd, Dd, Dd, Dd, Dd, Dd, Dd, Dd, Dd, Dd, Dd, Dd, Rd, Rd, Rd, Dd, Rd, Rd, Dd, Dd, Dd^Eff, Dd^Eff, Dd, Dd, Dd^Fdy, Dd, Rd, Rd, Dd, Dd, Rd, Dd, Dd, Dd, Dd^Es, Rd, Dd, Dd, Dd, Dd, Dd, Dd, Dd
Dd, Dd, Dd, Dd, Dd, Dd, Dd, Dd, Dd, Dd, Dd, Dd, Hd, Dd, Hd, Dd, Dd, Dd^Es, Dd, Dd, Dd, Dd, Rd, Dd, Rd, Dd, Dd, Dd, Rd, Dd, Dd, Dd^Vhr, Dd, Dd, Dd^Fdy, Dd^Fdy, Dd^Fdy, Dd, Dd, Rd, Rd, Rd, Dd, Dd, Dd, Dd, Dd, Dd, Hd, Hd, Hd, Hd, Hd, Hd
Dd, Dd, Dd, Dd, Dd, Dd, Dd, Dd, Dd, Dd, Dd, Dd, Hd, Hd, Dd, Hd^Es, Hd, Dd, Dd, Dd, Rd, Rd, Rd, Rd, Dd, Dd, Dd, Dd, Dd, Rd, Rd, Dd, Dd, Dd, Dd^Fyok, Dd^Fdy, Dd^Fetd, Dd^Fdy, Dd, Dd, Rd, Rd, Dd, Dd, Dd, Dd, Hd, Hd, Hd, Hd, Hd, Hd, Hd, Hd
Dd^Es, Dd^Es, Dd^Es, Dd^Es, Dd^Es, Dd, Dd, Dd, Dd, Dd, Dd^Es, Dd, Dd, Hd, Dd, Hd, Hd, Dd, Rd, Rd, Dd, Dd^Es, Dd, Dd, Hd, Hd, Hd, Hd, Hd, Rd, Rd, Dd, Dd, Dd^Fdy, Dd^Fdy, Dd^Fdy, Dd, Dd, Dd, Rd, Rd, Dd, Dd, Dd, Hd, Hd, Hd, Hd, Hd, Hd, Hd, Hd, Hd, Hd
Dd^Esd, Dd^Esd, Dd, Dd, Dd^Esd, Dd, Dd, Dd^Esd, Dd, Dd, Dd, Dd, Dd, Dd, Dd, Dd, Dd, Dd, Rd, Rd, Dd, Dd, Dd, Hd, Dd, Hd, Dd^Es, Hd, Hd, Rd, Dd, Rd, Rd, Dd, Dd, Dd, Dd, Rd, Rd, Rd, Dd, Dd, Dd, Dd, Dd, Dd, Dd, Hd, Dd, Hd, Hd, Hd, Hd, Hd
Dd, Dd, Hd, Dd^Esd, Hd, Dd, Dd, Dd, Hd, Hd, Hd, Dd, Dd, Dd, Dd, Dd, Rd, Dd, Rd, Rd, Hd, Dd^Es, Dd, Dd, Dd, Dd, Rd, Rd, Dd, Hd, Hd, Dd, Rd, Dd, Dd, Dd, Rd, Rd, Dd, Dd, Dd, Dd, Dd, Dd, Dd, Dd, Dd, Dd, Dd, Dd, Dd, Dd, Dd, Dd
Dd, Dd, Hd, Hd, Hd, Dd, Dd, Dd, Hd, Hd, Dd, Dd, Dd, Dd, Rd, Rd, Dd, Rd, Dd, Rd, Rd, Dd, Dd, Dd, Rd, Rd, Rd, Dd, Dd, Dd, Dd, Dd, Dd, Rd, Rd, Rd, Rd, Dd, Dd, Dd, Rd, Dd, Rd, Dd, Dd, Dd, Dd, Dd, Dd, Dd, Rd, Dd, Rd, Dd
Dd, Dd, Dd, Hd, Hd, Hd, Dd, Dd, Dd, Dd, Rd, Rd, Rd, Dd, Rd, Dd, Dd^Es, Dd, Dd, Rd, Rd, Rd, Rd, Rd, Rd, Rd, Dd, Dd, Hd, Dd, Dd, Dd, Dd, Rd, Rd, Rd, Rd, Rd, Dd, Rd, Dd, Rd, Dd, Chr, Dd, Dd, Dd, Dd, Dd, Dd, Dd, Rd, Dd, Rd
Dd, Dd, Dd, Dd, Dd, Dd, Rd, Dd, Rd, Rd, Re, Re, Re, Rd, Rd, Dd, Dd^Es, Dd^Es, Dd, Rd, Rd, Dd, Dd, Rd, Dd, Dd, Dd, Dd, Hd, Hd, Dd, Dd, Dd, Dd, Dd, Dd, Rd, Dd, Dd, Dd, Dd, Dd, Dd, Rd, Rd, Dd, Dd, Dd^Es, Dd, Dd, Dd, Dd, Dd, Dd
Rd, Dd, Dd, Dd, Dd, Dd, Rd, Rd, Re, Re, Ss, Rb^Fyok, Rd, Rd, Dd, Dd, Dd, Dd^Es, Rd, Rd, Rd, Dd, Hd, Rd, Hd, Hd, Hd, Dd, Dd, Dd, Dd, Dd, Dd^Es, Dd, Dd, Dd, Rd, Dd, Dd^Es, Dd^Es, Dd^Es, Dd, Dd, Dd, Dd, Rd, Dd, Dd, Hd, Hd, Hd, Dd, Dd, Dd
Dd, Rd, Dd, Dd, Dd, Dd, Rd, Re, Re^Es, Rb, Rb, Re, Rd, Dd, Rd, Rd, Dd, Dd, Rd, Rd, Rd, Dd, Dd, Hd, Hd, Hd, Hd, Dd, Dd, Dd^Es, Dd, Dd, Dd, Dd, Dd, Rd, Dd, Dd, Dd^Es, Dd, Dd, Dd, Dd, Dd, Hd, Dd, Dd, Dd, Dd, Hd, Hd, Dd, Dd, Dd
Dd, Dd, Dd, Dd, Dd, Dd, Dd, Rd, Rd, Re^Es, Rd, Re, Rd, Rd, Rd, Rd, Rd, Rd, Hd, Dd, Dd, Rd, Dd, Rd, Dd, Dd, Dd, Dd, Dd, Dd^Es, Dd, Dd, Rd, Rd, Rd, Rd, Dd, Dd, Dd, Dd, Dd, Dd, Hd, Hd, Hd, Hd, Dd, Dd, Dd, Dd, Dd, Dd, Dd, Dd
Dd^Esd, Dd, Dd^Esd, Dd, Dd, Dd, Dd, Dd, Rd, Rd, Dd, Rd, Dd, Dd, Dd, Rd, Dd, Hd, Hd, Dd, Dd, Rd, Rd, Rd, Dd, Dd, Dd, Dd, Dd, Dd, Rd, Rd, Dd, Rd, Rd, Rd, Dd, Dd, Dd, Dd, Dd, Dd, Hd, Hd, Hd, Rd, Rd, Dd, Dd, Dd, Rd, Rd, Rd, Dd
Dd^Esd, Dd^Esd, Dd, Dd, Dd, Dd, Rd, Rd, Dd^Es, Dd, Dd, Chr, Dd, Dd, Dd, Rd, Dd, Hd, Hd, Hd, Dd, Dd, Rd, Rd, Rd, Rd, Rd, Rd, Rd, Rd, Dd, Dd, Dd, Dd, Rd, Dd, Dd, Hd, Hd, Dd, Dd, Dd, Dd, Dd, Dd, Dd, Dd, Dd, Dd, Rd, Dd, Dd, Dd, Rd
Dd, Dd, Rd, Rd, Rd, Rd, Dd, Dd, Dd, Dd, Dd, Dd, Dd, Dd, Rd, Rd, Rd, Dd, Dd, Dd, Dd, Dd, Rd, Rd, Rd, Rd, Rd, Dd, Dd, Dd, Dd^Vct, Dd, Dd, Dd, Rd, Dd, Dd^Es, Dd, Hd, Hd, Dd, Rd, Dd, Dd, Dd, Dd, Dd, Dd, Dd, Dd, Dd, Dd, Dd, Dd
Rd, Rd, Dd, Dd, Dd, Dd, Dd, Dd, Dd, Dd, Dd, Dd, Dd^Es, Dd, Dd, Rd, Dd, Dd, Dd, Dd, Dd^Vct, Dd, Dd, Rd, Rd, Rd, Dd, Dd, Dd, Dd, Dd, Dd, Dd, Rd, Dd, Dd, Dd, Dd, Dd, Dd, Dd, Dd, Hd, Dd^Es, Dd, Dd, Rd, Dd, Dd, Dd, Dd, Dd, Dd, Dd
Dd, Dd, Hd, Hd, Dd, Dd, Rd, Dd^Esd, Rd, Dd, Hd, Dd, Dd, Dd, Dd, Rd, Dd, Dd, Dd, Dd, Dd, Dd, Dd, Rd, Ce, Ce, Ce, Dd, Dd, Dd, Dd, Dd, Dd, Rd, Dd, Dd, Dd, Dd, Dd, Dd, Dd, Hd, Hd, Dd, Rd, Rd, Rd, Dd, Dd, Dd, Dd, Dd, Dd, Dd
Dd, Hd, Dd, Hd, Dd, Rd, Dd, Dd, Rd, Dd, Dd^Esd, Hd, Dd, Dd, Rd, Rd, Dd, Dd, Dd, Dd^Es, Dd, Dd, Dd, Rd, Ce, 1 Ke, Ce, Dd, Dd, Dd, Dd, Dd, Dd, Rd, Rd, Dd, Dd, Dd^Es, Dd, Dd, Hd, Dd, Rd, Rd, Dd, Dd, Dd, Rd, Dd, Dd, Dd, Dd, Dd, Dd
Dd, Dd, Dd, Dd, Dd, Dd, Dd^Eff, Dd, Dd, Dd^Esd, Rd, Rd, Rd, Rd, Rd, Rd, Ce, Dd, Dd, Dd, Dd, Dd^Ecf, Dd, Rd, Rd, Ce, Rd, Dd, Dd, Dd, Dd, Dd, Dd, Dd, Rd, Ce, Dd, Dd, Dd, Dd, Hd, Hd, Dd, Dd, Dd, Dd, Dd, Dd, Rd, Dd, Dd, Dd, Dd, Dd
Dd, Dd, Dd, Dd, Dd^Eff, Dd^Eff, Rd, Rd, Dd, Dd, Dd, Rd, Dd, Rd, Rd, Ce, Ke, Ce, Dd, Dd, Dd, Dd, Dd, Rd, Rd, Rd, Dd, Dd, Dd, Dd^Vct, Dd, Dd, Dd, Rd, Ce, Ke, Ce, Dd, Dd, Dd, Dd, Dd, Dd^Esd, Dd^Esd, Dd^Esd, Dd, Dd, Dd, Rd, Dd, Rd, Dd, Dd, Dd
Dd, Dd, Dd, Dd^Eff, Dd, Dd, Rd, Dd, Dd, Dd, Dd, Dd, Rd, Dd, Rd, Rd, Dd, Dd, Dd, Dd, Dd, Dd, Dd, Rd, Rd, Rd, Dd, Dd, Dd, Dd, Dd, Dd^Es, Rd, Rd, Dd, Rd, Dd, Dd, Dd, Dd, Dd, Dd, Dd, Dd, Dd, Dd, Dd, Dd, Dd, Rd, Dd, Rd, Dd, Dd
