border_size=1
usage=map

Xos, Xos, Dd^Tbny, Dd^Tbny, Dd^Tbny, Dd^Tbny, Dd^Tbny, Dd, Dd, Dd, Dd, Dd, Dd, Dd^Tbny, Dd^Tbny, Dd^Tbny, Dd^Tbny, Dd^Tbny, Dd^Tbny, Dd^Tbny, Xos, Xos
Xos, Xos, Dd^Tbny, Dd^Tbny, Dd^Tbny, Dd^Tbny, Dd^Tbny, Dd, Dd, Tmmy, Dd, Dd, Dd, Dd^Tbny, Dd^Tbny, Dd^Tbny, Dd^Fyok, Dd^Tbny, Dd^Tbny, Dd^Tbny, Xos, Xos
Xos, Xos, Dd^Tbny, Dd^Tbny, Dd^Tbny, Dd^Tbny, Dd^Tbny, Dd, Dd^Tbny, Dd^Tbny, Dd, Dd, Dd^Tbny, Dd^Tbny, Dd^Tbny, Dd^Tbny, Dd^Tbny, Dd^Tbny, Dd^Tbny, Dd^Tbny, Xos, Xos
Xos, Xos^Tbny, Dd^Tbny, Dd^Tbny, Dd^Tbny, Dd^Tbny, Dd^Tbny, Dd^Tbny, Dd^Tbny, Dd^Tbny, Dd, Dd^Tbny, Dd^Tbny, Dd^Tbny, Dd^Tbny, Dd^Tbny, Dd^Tbny, Dd^Tbny, Dd^Tbny, Dd^Tbny, Xos, Xos
Xos, Xos, Dd^Tbny, Dd^Tbny, Dd^Fyok, Dd^Tbny, Dd, Dd, Dd, Dd, Dd, Dd, Dd, Dd, Dd, Dd^Tbny, Dd, Dd^Tbny, Dd, Dd^Tbny, Xos, Xos
Xos, Xos, Dd, Dd^Tbny, Dd, Dd, Rd, Dd^Bryl, Rd, Dd, Rb^Lyr|, Urb, Rd, Dd^Bryl, Dd, Dd, Dd^Es, Dd, Dd, Dd, Xos, Xos
Xos, Xos, Dd, Dd, Dd, Dd, Rd^Es, Rd, Rd, Rb^Lyl|, Rb^Lyr|, Rd, Rd, Rd, Dd^Es, Dd, Dd, Dd, Dd, Dd, Xos, Xos
Xos, Xos, Dd, Dd, Rd^Ecf, Dd, Dd, Rd, Rd, Rb^Lyl|, Rb^Lyr\, Rd, Rd, Rd, Dd, Dd^Ecf, Dd, Rd, Dd, Dd, Xos, Xos
Xos, Xos, Dd, Dd, Rd, Dd, Dd, Rd, Rd, Rb^Lyl|, Rb, Rb^Lyr\, Rd, Rd, Rd, Dd, Rd, Rd, Rd, Dd, Xos, Xos
Xos, Xos, Rd, Rd, Rd, 1 Dd, Dd, Rd, Rd, Rb^Lyl|, Rp, Rb^Lyr|, Urb, Urb, Urb, Urb, Urb, Rd, Urb, Urb, Xos, Xos
Xos, Xos, Rd, Rd, Rd, Rd, Urb, Urb, Urb, Rp^Lyl|, Rr, Rp^Lyr|, Urb, Urb, Urb, Urb, Urb, Urb, Urb, Urb, Xos, Xos
Xos, Xos, Urb, Urb, Urb, Urb, Urb, Urb, Urb, Rr^Lyl|, Rrc, Rr^Lyr|, Urb, Urb, Urb, Urb, Urb, Urb, Urb, Urb, Xos, Xos
Xos, Xos, Urb, Urb, Urb, Urb, Urb, Urb, Urb, Rrc^Lyl|, Rrc, Rrc^Lyr|, Urb, Urb, Urb, Urb, Urb, Urb, Urb, Urb, Xos, Xos
Xos, Xos, Urb, Urb, Urb, Urb, Urb, Urb, Urb, Rrc^Lyl|, Rrc, Rrc^Lyr|, Urb, Urb, Urb, Urb, Urb, Urb, Urb, Urb, Xos, Xos
Xos, Xos, Urb, Urb, Urb, Urb, Urb, Urb, Urb, Rrc^Lyl|, Rrc, Rrc^Lyr|, Urb, Urb, Urb, Urb, Urb, Urb, Urb, Urb, Xos, Xos
Xos, Xos, Urb, Urb, Urb, Urb, Urb, Urb, Urb, Rrc^Lyl|, Rrc, Rrc^Lyr|, Urb, Urb, Urb, Urb, Urb, Urb, Urb, Urb, Xos, Xos
Xos, Xos, Urb, Urb, Urb, Urb, Urb, Urb, Urb, Rrc^Lyl|, Rrc, Rrc^Lyr|, Urb, Urb, Urb, Urb, Urb, Urb, Urb, Urb, Xos, Xos
