border_size=1
usage=map

Xv, Xv, Xv, Xv, Xv, Xv, Xv, Xv, Xv, Xv, Xv, Xv, Xv, Xv, Xv, Xv, Xv, Xv, Xv, Xv, Xv, Xv, Xv, Xv, Xv, Xv, Xv, Xv, Xv, Xv, Xv, Xv, Xv, Xv, Xv, Xv, Xv
Xv, Xv, Xv, Xv, Xv, Xv, Xv, Xv, Xv, Xv, Xv, Xv, Xv, Xv, Xv, Xv, Xv, Xv, Xv, Xv, Xv, Xv, Xv, Xv, Xv, Xv, Xv, Xv, Xv, Xv, Xv, Xv, Xv, Xv, Xv, Xv, Xv
Xv, Xv, Xv, Xv, Xv, Xv, Xv, Xv, Xv, Xv, Xv, Xv, Xv, Xv, Xv, Xv, Xv, Xv, Xv, Xv, Xv, Xv, Xv, Xv, Xv, Xv, Xv, Xv, Xv, Xv, Xv, Xv, Xv, Xv, Xv, Xv, Xv
Xv, Xv, Xv, Xv, Xv, Xv, Xv, Xv, Xv, Xv, Xv, Xv, Xv, Xv, Xv, Xv, Xv, Xv, Xv, Xv, Xv, Xv, Xv, Xv, Xv, Xv, Xv, Xv, Xv, Xv, Xv, Xv, Xv, Xv, Xv, Xv, Xv
Xv, Xv, Xv, Xv, Xv, Xv, Xv, Xv, Xv, Xv, Xv, Xv, Xv, Xv, Xv, Xv, Xv, Xv, Xv, Xv, Xv, Xv, Xv, Xv, Xv, Xv, Xv, Xv, Xv, Xv, Xv, Xv, Xv, Xv, Xv, Xv, Xv
Xv, Xv, Xv, Xv, Xv, Xv, Xv, Xv, Xv, Xv, Xv, Xv, Xv, Xv, Xv, Xv, Xv, Xv, Xv, Xv, Xv, Xv, Xv, Xv, Xv, Xv, Xv, Xv, Xv, Xv, Xv, Xv, Xv, Xv, Xv, Xv, Xv
Xv, Xv, Xv, Xv, Xv, Xv, Xv, Xv, Xv, Xv, Xv, Xv, Xv, Xv, Xv, Xv, Xv, Xv, Xv, Xv, Xv, Xv, Xv, Xv, Xv, Xv, Xv, Xv, Xv, Xv, Xv, Xv, Xv, Xv, Xv, Xv, Xv
Xv, Xv, Xv, Xv, Xv, Xv, Xv, Xv, Xv, Xv, Xv, Xv, Xv, Xv, Xv, Xv, Xv, Xv, Xv, Xv, Xv, Xv, Xv, Xv, Xv, Xv, Xv, Xv, Xv, Xv, Xv, Xv, Xv, Xv, Xv, Xv, Xv
Xv, Xv, Xv, Xv, Xv, Xv, Xv, Xv, Xv, Xv, Xv, Xv, Xv, Xv, Xv, Xv, Xv, Xv, Xv, Xv, Xv, Xv, Xv, Xv, Xv, Xv, Xv, Xv, Xv, Xv, Xv, Xv, Xv, Xv, Xv, Xv, Xv
Xv, Xv, Xv, Xv, Xv, Xv, Xv, Xv, Xv, Xv, Xv, Xv, Xv, Xv, Xv, Xv, Xv, Xv, Xv, Xv, Xv, Xv, Xv, Xv, Xv, Xv, Xv, Xv, Xv, Xv, Xv, Xv, Xv, Xv, Xv, Xv, Xv
Xv, Xv, Xv, Xv, Xv, Xv, Xv, Xv, Xv, Xv, Xv, Xv, Xv, Xv, Xv, Xv, Xv, Xv, Xv, Xv, Xv, Xv, Xv, Xv, Xv, Xv, Xv, Xv, Xv, Xv, Xv, Xv, Xv, Xv, Xv, Xv, Xv
Xv, Xv, Xv, Xv, Xv, Xv, Xv, Xv, Xv, Xv, Xv, Xv, Xv, Xv, Xv, Xv, Xv, Xv, Xv, Xv, Xv, Xv, Xv, Xv, Xv, Xv, Xv, Xv, Xv, Xv, Xv, Xv, Xv, Xv, Xv, Xv, Xv
Xv, Xv, Xv, Xv, Xv, Xv, Xv, Xv, Xv, Xv, Xv, Xv, Xv, Xv, Xv, Xv, Xv, Xv, Xv, Xv, Xv, Xv, Xv, Xv, Xv, Xv, Xv, Xv, Xv, Xv, Xv, Xv, Xv, Xv, Xv, Xv, Xv
Xv, Xv, Xv, Xv, Xv, Xv, Xv, Xv, Xv, Xv, Xv, Xv, Xv, Xv, Xv, Xv, Xv, Xv, Xv, Xv, Xv, Xv, Xv, Xv, Xv, Xv, Xv, Xv, Xv, Xv, Xv, Xv, Xv, Xv, Xv, Xv, Xv
Xv, Xv, Xv, Xv, Xv, Xv, Xv, Xv, Xv, Xv, Xv, Xv, Xv, Xv, Xv, Xv, Xv, Xv, Xv, Xv, Xv, Xv, Xv, Xv, Xv, Xv, Xv, Xv, Xv, Xv, Xv, Xv, Xv, Xv, Xv, Xv, Xv
Xv, Xv, Xv, Xv, Xv, Xv, Xv, Xv, Xv, Xv, Xv, Xv, Xv, Xv, Xv, Xv, Xv, Xv, Xv, Xv, Xv, Xv, Xv, Xv, Xv, Xv, Xv, Xv, Xv, Xv, Xv, Xv, Xv, Xv, Xv, Xv, Xv
Xv, Xv, Xv, Xv, Xv, Xv, Xv, Xv, Xv, Xv, Xv, Xv, Xv, Xv, Xv, Xv, Xv, Xv, Xv, Xv, Xv, Xv, Xv, Xv, Xv, Xv, Xv, Xv, Xv, Xv, Xv, Xv, Xv, Xv, Xv, Xv, Xv
Xv, Xv, Xv, Xv, Xv, Xv, Xv, Xv, Xv, Xv, Xv, Xv, Xv, Xv, Xv, Xv, Xv, Xv, Xv, Xv, Xv, Xv, Xv, Xv, Xv, Xv, Xv, Xv, Xv, Xv, Xv, Xv, Xv, Xv, Xv, Xv, Xv
Xv, Xv, Xv, Xv, Xv, Xv, Xv, Xv, Xv, Xv, Xv, Xv, Xv, Xv, Xv, Xv, Xv, Xv, Xv, Xv, Xv, Xv, Xv, Xv, Xv, Xv, Xv, Xv, Xv, Xv, Xv, Xv, Xv, Xv, Xv, Xv, Xv
Xv, Xv, Xv, Xv, Xv, Xv, Xv, Xv, Xv, Xv, Xv, Xv, Xv, Xv, Xv, Xv, Xv, Xv, Xv, Xv, Xv, Xv, Xv, Xv, Xv, Xv, Xv, Xv, Xv, Xv, Xv, Xv, Xv, Xv, Xv, Xv, Xv
Xv, Xv, Xv, Xv, Xv, Xv, Xv, Xv, Xv, Xv, Xv, Xv, Xv, Xv, Xv, Xv, Xv, Xv, Xv, Xv, Xv, Xv, Xv, Xv, Xv, Xv, Xv, Xv, Xv, Xv, Xv, Xv, Xv, Xv, Xv, Xv, Xv
Xv, Xv, Xv, Xv, Xv, Xv, Xv, Xv, Xv, Xv, Xv, Xv, Xv, Xv, Xv, Xv, Xv, Xv, Xv, Xv, Xv, Xv, Xv, Xv, Xv, Xv, Xv, Xv, Xv, Xv, Xv, Xv, Xv, Xv, Xv, Xv, Xv
Xv, Xv, Xv, Xv, Xv, Xv, Xv, Xv, Xv, Xv, Xv, Xv, Xv, Xv, Xv, Xv, Xv, Xv, Xv, Xv, Xv, Xv, Xv, Xv, Xv, Xv, Xv, Xv, Xv, Xv, Xv, Xv, Xv, Xv, Xv, Xv, Xv
Xv, Xv, Xv, Xv, Xv, Xv, Xv, Xv, Xv, Xv, Xv, Xv, Xv, Xv, Xv, Xv, Xv, Xv, Xv, Xv, Xv, Xv, Xv, Xv, Xv, Xv, Xv, Xv, Xv, Xv, Xv, Xv, Xv, Xv, Xv, Xv, Xv
Xv, Xv, Xv, Xv, Xv, Xv, Xv, Xv, Xv, Xv, Xv, Xv, Xv, Xv, Xv, Xv, Xv, Xv, Xv, Xv, Xv, Xv, Xv, Xv, Xv, Xv, Xv, Xv, Xv, Xv, Xv, Xv, Xv, Xv, Xv, Xv, Xv
Xv, Xv, Xv, Xv, Xv, Xv, Xv, Xv, Xv, Xv, Xv, Xv, Xv, Xv, Xv, Xv, Xv, Xv, Xv, Xv, Xv, Xv, Xv, Xv, Xv, Xv, Xv, Xv, Xv, Xv, Xv, Xv, Xv, Xv, Xv, Xv, Xv
Xv, Xv, Xv, Xv, Xv, Xv, Xv, Xv, Xv, Xv, Xv, Xv, Xv, Xv, Xv, Xv, Xv, Xv, Xv, Xv, Xv, Xv, Xv, Xv, Xv, Xv, Xv, Xv, Xv, Xv, Xv, Xv, Xv, Xv, Xv, Xv, Xv
Xv, Xv, Xv, Xv, Xv, Xv, Xv, Xv, Xv, Xv, Xv, Xv, Xv, Xv, Xv, Xv, Xv, Xv, Xv, Xv, Xv, Xv, Tptz, Tptz, Tptz, Xv, Xv, Xv, Xv, Xv, Xv, Xv, Xv, Xv, Xv, Xv, Xv
Xv, Xv, Xv, Xv, Xv, Xv, Xv, Xv, Xv, Xv, Xv, Xv, Xv, Xv, Xv, Xv, Xv, Xv, Xv, Xv, Xv, Xv, Tptz, Tptz, Tptz, Xv, Xv, Xv, Xv, Xv, Xv, Xv, Xv, Xv, Xv, Xv, Xv
Xv, Xv, Xv, Xv, Xv, Xv, Xv, Xv, Xv, Xv, Xv, Xv, Xv, Xv, Xv, Xv, Xv, Xv, Xv, Xv, Xv, Xv, Tphz, Tphz, Tphz, Xv, Xv, Xv, Xv, Xv, Xv, Xv, Xv, Xv, Xv, Xv, Xv
Xv, Xv, Xv, Xv, Xv, Xv, Xv, Xv, Xv, Xv, Xv, Xv, Xv, Xv, Xv, Xv, Xv, Xv, Xv, Xv, Xv, Xv, Tphz, Tphz, Tphz, Xv, Xv, Xv, Xv, Xv, Xv, Xv, Xv, Xv, Xv, Xv, Xv
Xv, Xv, Xv, Xv, Xv, Xv, Xv, Xv, Xv, Xv, Xv, Xv, Xv, Xv, Xv, Xv, Xv, Xv, Xv, Xv, Xv, Xv, Tphz, Tphz, Tphz, Xv, Xv, Xv, Xv, Xv, Xv, Xv, Xv, Xv, Xv, Xv, Xv
Xv, Xv, Xv, Xv, Xv, Xv, Xv, Xv, Xv, Xv, Xv, Xv, Xv, Xv, Xv, Xv, Xv, Xv, Xv, Xv, Tptz, Tptz, Tphz^Tyod, Tphz, Tphz^Tycd, Tptz, Tptz, Xv, Xv, Xv, Xv, Xv, Xv, Xv, Xv, Xv, Xv
Xv, Xv, Xv, Xv, Xv, Xv, Xv, Xv, Xv, Xv, Xv, Xv, Xv, Xv, Xv, Xv, Xv, Xv, Xv, Xv, Tptz, Tptz, Tptz, Tptz, Tptz, Tptz, Tptz, Xv, Xv, Xv, Xv, Xv, Xv, Xv, Xv, Xv, Xv
Xv, Xv, Xv, Xv, Xv, Xv, Xv, Xv, Xv, Xv, Xv, Xv, Xv, Xv, Xv, Xv, Xv, Xv, Xv, Xv, Tptz, Tptz, Tptz, Tptz, Tptz, Tptz, Tptz, Xv, Xv, Xv, Xv, Xv, Xv, Xv, Xv, Xv, Xv
Xv, Xv, Xv, Xv, Xv, Xv, Xv, Xv, Xv, Xv, Xv, Xv, Xv, Xv, Xv, Xv, Xv, Xv, Xv, Xv, Tphz, Tphz, Tphz, Tphz, Tphz, Tphz, Tphz, Xv, Xv, Xv, Xv, Xv, Xv, Xv, Xv, Xv, Xv
Xv, Xv, Xv, Xv, Xv, Xv, Xv, Xv, Xv, Xv, Xv, Xv, Xv, Xv, Xv, Xv, Xv, Xv, Xv, Xv, Tphz, Tphz, Tphz, Tphz, Tphz, Tphz, Tphz, Xv, Xv, Xv, Xv, Xv, Xv, Xv, Xv, Xv, Xv
Xv, Xv, Xv, Xv, Xv, Xv, Xv, Xv, Xv, Xv, Xv, Xv, Xv, Xv, Xv, Xv, Xv, Xv, Xv, Tptz, Tphz, Tphz, Tphz, Tphz, Tphz, Tphz, Tphz, Tptz, Xv, Xv, Xv, Xv, Xv, Xv, Xv, Xv, Xv
Xv, Xv, Xv, Xv, Xv, Xv, Xv, Xv, Xv, Xv, Xv, Xv, Xv, Xv, Xv, Xv, Xv, Xv, Xv, Tptz, Tphz^Tycd, Tfhz, Tphz^Tpwz, Tfhz, Tphz^Tyod, Tfhz, Tphz, Tptz, Xv, Xv, Xv, Xv, Xv, Xv, Xv, Xv, Xv
Xv, Xv, Xv, Xv, Xv, Xv, Xv, Xv, Xv, Xv, Xv, Xv, Xv, Xv, Xv, Xv, Xv, Xv, Xv, Tptz, Tptz, Tptz, Tptz, Tptz, Tptz, Tptz, Tptz, Tptz, Xv, Xv, Xv, Xv, Xv, Xv, Xv, Xv, Xv
Xv, Xv, Xv, Xv, Xv, Xv, Xv, Xv, Xv, Xv, Xv, Xv, Xv, Xv, Xv, Xv, Xv, Xv, Xv, Tptz, Tptz, Tptz, Tptz, Tptz, Tptz, Tptz, Tptz, Tptz, Xv, Xv, Xv, Xv, Xv, Xv, Xv, Xv, Xv
Xv, Xv, Xv, Xv, Xv, Xv, Xv, Xv, Xv, Xv, Xv, Xv, Xv, Xv, Xv, Xv, Xv, Xv, Xv, Tptz, Tphz, Tptz, Tphz, Tptz, Tphz, Tptz, Tphz, Tptz, Xv, Xv, Xv, Xv, Xv, Xv, Xv, Xv, Xv
Xv, Xv, Xv, Xv, Xv, Xv, Xv, Xv, Xv, Xv, Xv, Xv, Xv, Xv, Xv, Xv, Xv, Xv, Xv, Tphz, Tphz, Tphz, Tphz, Tphz, Tphz, Tphz, Tphz, Tphz, Xv, Xv, Xv, Xv, Xv, Xv, Xv, Xv, Xv
Xv, Xv, Xv, Xv, Xv, Xv, Xv, Xv, Xv, Xv, Xv, Xv, Xv, Xv, Xv, Xv, Xv, Xv, Tptz, Tphz^Tpwz, Tphz, Tphz, Tphz, Tphz^Tpwz, Tphz, Tphz, Tphz, Tphz, Tptz, Xv, Xv, Xv, Xv, Xv, Xv, Xv, Xv
Xv, Xv, Xv, Xv, Xv, Xv, Xv, Xv, Xv, Xv, Xv, Xv, Xv, Xv, Xv, Xv, Xv, Xv, Tptz, Tphz, Tfhz, Tphz, Tfhz, Tphz, Tfhz, Tphz, Tfhz, Tphz, Tptz, Tptz, Xv, Xv, Xv, Xv, Xv, Xv, Xv
Xv, Xv, Xv, Xv, Xv, Xv, Xv, Xv, Xv, Xv, Xv, Xv, Xv, Xv, Xv, Xv, Xv, Xv, Tptz, Tphz^Tpwz, Tptz, Tphz^Tycd, Tptz, Tphz^Tpwz, Tptz, Tphz^Tpwz, Tptz, Tphz^Tyod, Tptz, Tptz, Xv, Xv, Xv, Xv, Xv, Xv, Xv
Xv, Xv, Xv, Xv, Xv, Xv, Xv, Xv, Xv, Xv, Xv, Xv, Xv, Xv, Tptz, Tptz^Bryu, Tptz, Xv, Tptz, Tptz, Tptz, Tptz, Tptz, Tptz, Tptz, Tptz, Tptz, Tptz, Tptz, Tptz, Xv, Xv, Xv, Xv, Xv, Xv, Xv
Xv, Xv, Xv, Xv, Xv, Xv, Xv, Xv, Xv, Xv, Xv, Xv, Xv, Xv, Tphz, Tptz, Tphz, Xv, Tphz, Tphz, Tphz, Tphz, Tphz, Tphz, Tphz, Tphz, Tphz, Tphz, Tphz, Tphz, Xv, Xv, Xv, Xv, Xv, Xv, Xv
Xv, Xv, Xv, Xv, Xv, Xv, Xv, Xv, Xv, Xv, Xv, Xv, Xv, Xv, Tphz^Tpwz, Tphz, Tphz^Tpwz, Xv, Tphz^Tpwz, Tphz, Tphz^Tpwz, Tphz, Tphz^Tpwz, Tphz, Tphz^Tpwz, Tphz, Tphz^Tpwz, Tphz, Tphz^Tpwz, Tphz^Tpwz, Xv, Xv, Xv, Xv, Xv, Xv, Xv
Xv, Xv, Xv, Xv, Xv, Xv, Xv, Xv, Xv, Xv, Xv, Xv, Tptz, Tptz, Tphz, Tphz^Tpwz, Tphz, Tptz, Tphz, Tphz, Tphz, Tphz, Tphz, Tphz, Tphz, Tphz, Tphz, Tphz, Tphz, Tphz, Tptz, Xv, Xv, Xv, Xv, Xv, Xv
Xv, Xv, Xv, Xv, Xv, Xv, Xv, Xv, Xv, Xv, Xv, Xv, Tptz, Tptz, Tphz, Tphz, Tphz, Tptz, Tphz, Tfhz, Tphz^Tyod, Tfhz, Tphz, Tfhz, Tphz, Tfhz, Tphz^Tycd, Tfhz, Tphz, Tphz, Tptz, Tptz, Xv, Xv, Xv, Xv, Xv
Xv, Xv, Xv, Xv, Xv, Xv, Xv, Xv, Xv, Xv, Xv, Xv, Tptz, Tptz, Tptz, Tphz^Tyod, Tptz, Tptz, Tptz, Tptz, Tptz, Tptz, Tptz, Tptz, Tptz, Tptz, Tptz, Tptz, Tptz, Tptz, Tptz, Tptz, Xv, Xv, Xv, Xv, Xv
Xv, Xv, Xv, Xv, Xv, Xv, Xv, Xv, Xv, Xv, Xv, Xv, Tptz, Tptz, Tptz, Tptz, Tptz, Tptz, Tptz, Tptz, Tptz, Tptz, Tptz, Tptz, Tptz, Tptz, Tptz, Tptz, Tptz, Tptz, Tphz, Tphz, Xv, Xv, Xv, Xv, Xv
Xv, Xv, Xv, Xv, Xv, Xv, Xv, Xv, Xv, Xv, Xv, Xv, Tphz, Tptz, Tphz, Tptz, Tphz, Tptz, Tphz, Tptz, Tphz, Tptz, Tphz, Tptz, Tphz, Tptz, Tphz, Tptz, Tphz, Tphz, Tphz^Tpwz, Tphz^Tpwz, Xv, Xv, Xv, Xv, Xv
Xv, Xv, Xv, Xv, Xv, Xv, Xv, Xv, Xv, Xv, Xv, Xv, Tphz^Tpwz, Tphz, Tphz, Tphz, Tphz, Tphz, Tphz, Tphz, Tphz, Tphz, Tphz, Tphz, Tphz, Tphz, Tphz, Tphz, Tphz^Tpwz, Tphz^Tpwz, Tphz, Tphz, Tptz, Xv, Xv, Xv, Xv
Xv, Xv, Xv, Xv, Xv, Xv, Xv, Xv, Xv, Xv, Xv, Xv, Tphz, Tphz^Tpwz, Tphz, Tphz^Tpwz, Tphz, Tphz^Tpwz, Tphz, Tphz^Tpwz, Tphz, Tphz^Tpwz, Tphz, Tphz^Tpwz, Tphz, Tphz^Tpwz, Tphz, Tphz^Tpwz, Tphz, Tphz, Tphz, Tphz, Tptz, Tptz, Xv, Xv, Xv
Xv, Xv, Xv, Xv, Xv, Xv, Xv, Xv, Xv, Xv, Xv, Tptz, Tphz, Tphz, Tfhz, Tphz, Tfhz, Tphz, Tphz^Tpwz, Tphz, Tfhz, Tphz, Tfhz, Tphz, Tfhz, Tphz, Tfhz, Tphz, Tphz, Tphz, Tptz, Tptz, Tptz, Tptz, Xv, Xv, Xv
Xv, Xv, Xv, Xv, Xv, Xv, Xv, Xv, Xv, Xv, Xv, Tptz, Tptz, Tphz^Tpwz, Tptz, Tphz^Tycd, Tptz, Tphz^Tpwz, Tptz, Tphz, Tptz, Tphz^Tpwz, Tptz, Tphz, Tptz, Tphz^Tpwz, Tptz, Tphz^Tyod, Tptz, Tptz, Tptz, Tptz, Tptz, Tptz, Xv, Xv, Xv
Xv, Xv, Xv, Xv, Xv, Xv, Xv, Xv, Xv, Xv, Xv, Tptz, Tptz, Tptz, Tptz, Tptz, Tptz, Tptz, Tptz, Tptz, Tptz, Tptz, Tptz, Tptz, Tptz, Tptz, Tptz, Tptz, Tptz, Tptz, Tptz^Tbny, Tptz, Tptz, Tptz, Xv, Xv, Xv
Xv, Xv, Xv, Xv, Xv, Xv, Xv, Xv, Xv, Xv, Xv, Tptz, Tptz, Tptz, Tptz, 1 Tptz, Tptz, Tptz, Tptz, Tptz, Tptz, Tptz, Tptz, Tptz, Tptz, Tptz, Tptz, Tptz, Tptz, Tptz, Tptz, Tptz, Tptz, Tptz, Xv, Xv, Xv
Xv, Xv, Xv, Xv, Xv, Xv, Xv, Xv, Xv, Xv, Xv, Tptz, Tphz, Tptz, Tphz, Tptz, Tphz, Tptz, Tphz, Tptz^Bryl, Tphz, Tptz^Bryl, Tphz, Tptz^Bryl, Tphz, Tptz^Bryl, Tphz, Tptz, Tphz, Tptz, Tphz, Tptz, Tphz, Tphz, Xv, Xv, Xv
Xv, Xv, Xv, Xv, Xv, Xv, Xv, Xv, Xv, Xv, Xv, Tphz, Tphz, Tphz, Tphz, Tphz, Tphz, Tphz, Tphz, Tphz, Tphz, Tphz, Tphz, Tphz, Tphz, Tphz, Tphz, Tphz, Tphz, Tphz, Tphz, Tphz, Tphz^Tpwz, Tphz^Tpwz, Xv, Xv, Xv
Xv, Xv, Xv, Xv, Xv, Xv, Xv, Xv, Xv, Xv, Xv, Tphz, Tphz, Tphz, Tphz, Tphz, Tphz, Tphz, Tphz, Tphz, Tphz, Tphz, Tphz, Tphz, Tphz, Tphz, Tphz, Tphz, Tphz^Tpwz, Tphz, Tphz, Tphz^Tpwz, Tphz, Tphz, Xv, Xv, Xv
Xv, Xv, Xv, Xv, Xv, Tptz^Ecf, Xv, Xv, Xv, Xv, Xv, Tphz, Tfhz, Tphz, Tfhz, Tphz, Tfhz, Tphz, Tphz, Tphz, Tphz, Tphz, Tphz, Tphz, Tphz, Tphz, Tphz, Tphz, Tfhz, Tphz, Tfhz, Tphz, Tphz, Tphz, Tptz, Tptz, Tptz
Xv, Xv, Xv, Xv, Tptz, Tphz, Tptz, Xv, Tptz^Bryu, Xv, Tptz, Tphz, Tptz, Tphz^Tpwz, Tptz, Tphz^Tyod, Tptz, Tphz^Tpwz, Tptz, Tphz, Tptz, Tphz, Tptz, Tphz, Tptz, Tphz, Tptz, Tphz, Tptz, Tphz^Tyod, Tptz, Tphz^Tpwz, Tptz, Tptz, Tptz, Tptz, Tptz
Xv, Xv, Xv, Tptz, Tptz, Tptz, Tptz, Xv, Tptz, Xv, Tptz, Tptz, Tptz, Tptz, Tptz, Tptz, Tptz, Tptz, Tptz, Tptz, Tptz, Tptz, Tptz, 4 Tptz, Tptz, Tptz, Tptz, Tptz, Tptz, Tptz, Tptz, Tptz, Tptz, Tptz, Tphz, Tphz, Tphz
Xv, Xv, Xv, Tphz, Tphz, Tphz, Tphz, Xv, Tphz, Xv, Tphz, Tphz, Tphz, Tphz, Tphz, Tphz, Tphz, Tphz, Tphz, Tphz, Tphz, Tphz, Tphz, Tphz, Tphz, Tphz, Tphz, Tphz, Tphz, Tphz, Tphz, Tphz, Tphz, Tphz, Tphz, Tphz^Tpwz, Tphz
Xv, Xv, Tptz, Tphz^Tpwz, Tphz^Tpwz, Tphz, Tphz, Tptz, Tphz, Tptz, Tphz, Tphz, Tphz^Tpwz, Tphz, Tphz^Tpwz, Tphz, Tphz^Tpwz, Tphz, Tphz^Tpwz, Tphz, Tphz^Tpwz, Tphz, Tphz^Tpwz, Tphz, Tphz^Tpwz, Tphz, Tphz^Tpwz, Tphz, Tphz^Tpwz, Tphz, Tphz^Tpwz, Tphz, Tphz^Tpwz, Tphz^Tpwz, Tphz, Tphz^Tpwz, Tphz
Xv, Tptz, Tptz, Tphz^Tpwz, Tphz^Tpwz, Tphz, Tphz, Tptz, Tphz^Tyod, Tptz, Tphz, Tphz, Tphz, Tphz, Tphz, Tphz, Tphz, Tphz, Tphz, Tphz, Tphz, Tphz, Tphz, Tphz, Tphz, Tphz, Tphz, Tphz, Tphz, Tphz, Tphz^Tpwz, Tphz, Tphz^Tpwz, Tphz^Tpwz, Tphz, Tfhz, Tphz
Xv, Tptz, Tptz, Tphz, Tphz, Tfhz, Tphz^Tyod, Tptz, Tptz, Tptz, Tphz, Tfhz, Tphz^Tycd, Tfhz, Tphz, Tfhz, Tphz, Tfhz, Tphz^Tpwz, Tfhz, Tphz, Tfhz, Tphz^Tycd, Tfhz, Tphz, Tfhz, Tphz^Tpwz, Tfhz, Tphz, Tfhz, Tphz, Tfhz, Tphz, Tphz, Tptz, Tptz, Tptz
Xv, Tptz, Tptz, Tptz, Tptz, Tptz, Tptz, Tptz, Tptz, Tptz, Tptz, Tptz, Tptz, Tptz, Tptz, Tptz, Tptz, Tptz, Tptz, Tptz, Tptz, Tptz, Tptz, Tptz, Tptz, Tptz, Tptz, Tptz, Tptz, Tptz, Tptz, Tptz, Tptz, Tptz, Tptz, Tptz, Tptz
Xv, Tptz, Tptz, Tptz, Tptz, Tptz, Tptz, Tptz, Tptz, Tptz, Tptz, Tptz, Tptz, Tptz, Tptz, Tptz, Tptz, Tptz, Tptz, Tptz, Tptz, Tptz, Tptz, Tptz, Tptz, Tptz, Tptz, Tptz, Tptz, Tptz, Tptz, Tptz, Tptz, Tptz, Tptz, Tptz, Tptz
Xv, Tptz, Tphz, Tptz, Tphz, Tptz, Tphz, Tptz, Tphz, Tptz, Tphz, Tptz, Tphz, Tptz, Tphz, Tptz^Bryl, Tphz, Tptz, Tphz, Tptz, Tphz, Tptz, Tphz, Tptz, Tphz, Tptz, Tphz, Tptz, Tphz, Tptz, Tphz, Tptz, Tphz, Tptz, Tphz, Tptz, Tphz
Dd, Tphz, Tphz^Tpwz, Tphz, Tphz^Tpwz, Tphz, Tphz, Tphz, Tphz, Tphz, Tphz, Tphz, Tphz, Tphz, Tphz, Tphz, Tphz, Tphz, Tphz, Tphz, Tphz, Tphz, Tphz, Tphz, Tphz, Tphz, Tphz, Tphz^Tpwz, Tphz, Tphz^Tpwz, Tphz, Tphz^Tpwz, Tphz, Tphz, Tphz, Tphz, Tphz
Dd, Tphz, Tphz, Tphz, Tphz, Tphz, Tphz, Tphz, Tphz, Tphz^Tpwz, Tphz, Tphz, Tphz, Tphz^Tpwz, Tphz, Tphz, Tphz, Tphz, Tphz, Tphz^Tpwz, Tphz, Tphz, Tphz, Tphz^Tpwz, Tphz, Tphz, Tphz, Tphz, Tphz, Tphz, Tphz, Tphz, Tphz, Tphz, Tphz, Tphz, Tphz
Dd, Tphz^Tpwz, Tfhz, Tphz^Tpwz, Tfhz, Tphz^Tpwz, Tfhz, Tphz, Tfhz, Tphz, Tfhz, Tphz^Tpwz, Tfhz, Tphz, Tphz, Tphz, Tphz, Tphz, Tfhz, Tphz, Tfhz, Tphz^Tpwz, Tfhz, Tphz, Tfhz, Tphz, Tfhz, Tphz^Tpwz, Tfhz, Tphz^Tpwz, Tfhz, Tphz^Tpwz, Tfhz, Tphz, Tfhz, Tphz, Tphz
Dd, Tphz, Dd, Tphz, Dd, Tphz, Dd, Tphz, Dd^Tbny, Tphz, Dd, Tphz, Dd, Tphz, Rd, Tphz^Tycd, Rd, Tphz, Dd, Tphz, Dd, Tphz, Dd, Tphz, Dd, Tphz, Dd, Tphz, Dd, Tphz, Dd, Tphz, Dd, Tphz, Dd, Tphz, Dd
Dd, Dd, Dd^Tbny, Dd, Dd^Tbny, Dd, Dd^Tbny, Dd^Tbny, Dd^Tbny, Dd^Tbny, Dd, Dd, Tptz^Bryl, Rd, Rd, Rd, Rd, Rd, Tptz^Bryl, Dd, Dd, Dd, Dd, Dd, Dd^Tbny, Dd, Dd^Tbny, Dd^Tbny, Dd^Tbny, Dd^Tbny, Dd^Tbny, Dd^Tbny, Dd^Tbny, Dd^Tbny, Dd^Tbny, Dd^Tbny, Dd^Tbny
Dd^Tbny, Dd^Tbny, Dd^Tbny, Dd^Tbny, Dd^Tbny, Dd^Tbny, Rd^Tbny, Dd^Tbny, Dd^Tbny, Dd^Tbny, Dd, Tptz^Xo, Tptz^Xo, Tptz^Xo, Rd, 2 Rd, Rd, Tptz^Xo, Tptz^Xo, Tptz^Xo, Dd, Dd, Dd, Dd, Dd^Tbny, Dd^Tbny, Dd^Tbny, Dd^Tbny, Dd^Tbny, Dd^Tbny, Dd^Tbny, Dd^Tbny, Dd^Tbny, Dd^Tbny, Dd^Tbny, Dd^Tbny, Dd^Tbny
Uue^Tbny, Dd^Tbny, Dd^Tbny, Dd^Tbny, Dd^Tbny, Dd^Tbny, Dd^Tbny, Rd^Tbny, Dd^Tbny, Dd^Tbny, Dd, Tphz, Tphz, Tphz, Rd, Rd, Rd, Tphz, Tphz, Tphz, Dd, Dd, Dd, Dd^Tbny, Dd^Tbny, Dd^Tbny, Dd^Tbny, Dd^Tbny, Dd^Tbny, Dd^Tbny, Dd^Tbny, Dd^Tbny, Dd^Tbny, Dd^Tbny, Uue^Tbny, Dd^Tbny, Uue
Uue^Tbny, Uue^Tbny, Uue^Tbny, Dd^Tbny, Dd^Tbny, Dd^Tbny, Dd^Tbny, Rd^Tbny, Rd, Dd, Dd, Tphz, Tphz, Tphz, Rd, Rd, Rd, Tphz, Tphz, Tphz, Dd, Dd, Dd, Dd^Tbny, Rd^Tbny, Dd^Tbny, Dd^Tbny, Dd^Tbny, Dd^Tbny, Dd^Tbny, Uue^Tbny, Uue^Tbny, Uue^Tbny, Uue^Tbny, Uue^Tbny, Uue, Uue
Dd^Tbny, Dd^Tbny, Dd^Tbny, Uue^Tbny, Uue^Tbny, Uue, Uue, Dd^Tbny, Dd, Rd, Rd, Dd, Rd, Dd, Rd, Rd, Rd, Dd, Rd, Dd, Dd, Dd, Dd, Rd^Tbny, Dd^Tbny, Dd^Tbny, Dd^Tbny, Dd^Tbny, Dd^Tbny, Uue^Tbny, Uue^Tbny, Uue^Tbny, Dd^Tbny, Dd^Tbny, Dd^Tbny, Dd^Tbny, Dd
Dd^Tbny, Dd^Tbny, Dd^Tbny, Dd^Tbny, Uue^Tbny, Dd, Dd, Uue, Uue, Rd, Rd, Rd, Rd, Dd, Rd, Rd, Dd, Dd, Rd, Rd, Dd, Dd, Rd, Rd, Dd^Tbny, Dd^Tbny, Dd^Tbny, Dd^Tbny, Dd^Tbny, Dd^Tbny, Dd^Tbny, Dd^Tbny, Dd^Tbny, Dd^Tbny, Dd^Tbny, Dd^Tbny, Dd^Tbny
Dd^Tbny, Dd^Tbny, Dd^Tbny, Dd^Tbny, Dd^Tbny, Uue^Tbny, Uue, Uue, Uue^Tbny, Uue, Dd, Dd, Dd, Rd, Rd, Rd, Rd, Rd, Rd, Rd, Rd, Rd, Rd, Dd^Tbny, Dd^Tbny, Dd^Tbny, Dd^Tbny, Dd^Tbny, Dd^Tbny, Dd^Tbny, Dd^Tbny, Dd^Tbny, Dd^Tbny, Dd^Tbny, Dd^Tbny, Dd^Tbny, Dd^Tbny
Uue, Dd^Tbny, Dd^Tbny, Dd^Tbny, Dd^Tbny, Dd^Tbny, Dd^Tbny, Dd^Tbny, Dd^Tbny, Uue, Dd, Dd, Dd, Dd, Dd^Tazc, Rd, Dd, Dd, Dd, Dd, Dd, Dd, Dd, Dd^Tbny, Dd^Tbny, Dd^Tbny, Dd^Tbny, Dd^Tbny, Uue^Tbny, Dd^Tbny, Uue^Tbny, Dd^Tbny, Uue^Tbny, Dd^Tbny, Uue^Tbny, Dd^Tbny, Uue^Tbny
Qxe, Uue, Uue, Dd, Dd, Dd^Tbny, Dd^Tbny, Dd^Tbny, Dd^Tbny, Dd, Dd^Tbny, Dd, Dd^Ecf, Dd, Rd, Rd, Dd, Dd, Dd^Ecf, Dd, Dd, Dd, Uue, Dd, Dd, Dd^Tbny, Uue^Tbny, Uue^Tbny, Uue^Tbny, Uue^Tbny, Uue^Tbny, Uue^Tbny, Uue^Tbny, Uue^Tbny, Uue^Tbny, Uue^Tbny, Uue^Tbny
Qxe, Qxe, Qxe, Uue, Uue, Dd, Uue, Dd, Dd, Dd, Dd, Dd, Dd, Dd, Dd, Rd, Dd, Dd, Dd, Dd, Dd, Dd, Uue, Dd, Uue, Uue, Uue, Uue^Tbny, Uue, Uue, Uue, Uue^Tbny, Uue, Uue^Tbny, Uue, Uue^Tbny, Qxe
Qxe, Qxe, Qxe, Qxe, Qxe, Uue, Qxe, Uue, Uue^Fetd, Dd, Dd, Dd, Dd, Dd, Dd, Rd, Rd, Dd, Dd, Dd, Dd, Rd, Rd, Uue, Uue, Uue^Fetd, Uue, Uue, Uue, Ur, Uue, Uue, Uue, Qxe, Qxe, Qxe, Qxe
Qxe, Qxe, Qxe, Qxe, Uue, Qxe, Uue, Uue, Uue, Uue, Uue, Dd, Dd, Dd, Dd, Rd, Rd, Dd, Dd, Dd, Rd, Rd, Dd, Dd, Uue, Uue, Ur, Ur, Ur, Ur, Uue, Uue, Qxe, Qxe, Qxe, Qxe, Qxe
Qxe, Qxe, Uue, Uue, Ur, Uue, Uue, Uue, Dd^Tbny, Dd^Tbny, Dd^Tbny, Dd, Dd, Dd, Dd, Rd, Rd, Rd, Dd, Rd, Rd, Rd, Uue, Uue, Ur, Ur, Ur, Ur, Uue, Uue, Uue, Uue, Uue, Qxe, Qxe, Qxe, Qxe
Uue, Uue, Uue, Ur, Ur, Ur, Ur, Uue, Uue, Dd^Tbny, Uue, Dd, Dd, Dd, Rd, 3 Rd, Rd, Dd, Rd, Rd, Rd, Ur, Ur, Ur, Uue, Ur, Uue, Uue, Uue, Uue, Uue, Uue, Uue, Uue, Uue, Qxe, Qxe
Gg, Uue, Uue, Uue, Uue, Ur, Ur, Uue, Uue, Uue, Uue, Uue, Dd, Dd, Rd, Rd, Rd, Rd, Dd, Dd, Dd, Ur, Uue, Uue, Uue, Uue, Uue, Uue, Uue, Uue, Uue, Uue, Uue, Uue, Uue, Uue, Uue
