border_size=1
usage=map

Xos, Xos, Xos, Xos, Xos, Xos, Xos, Xos, Xos, Xos, Xos, Xos, Xos, Xos, Xos, Xos, Xos, Xos, Xos, Xos, Xos, Xos, Xos, Xos
Xos, Xos, Rr, Rr, Rr, Rr, Rr, Xos, Xos, Xos, Rr, Xos, Xos, Xos, Xos, Xos, Urb, Urb, Urb, Xos, Xos, Xos, Xos, Xos
Xos, Rr, Rr, Rr, Rr, Rr, Xos, Xos, Rr, Rr, Rr, Rr, Rr, Xos, Xos, Urb, Urb, Urb, 2 Urb, Urb^Bryl, Urb, Xos, Xos, Xos
Xos, Rr, Rr, Rr, Rr, Rr, Rr, Rr, Rr, Rr, Xos, Rr, Rr, Rr, Rr, Xos, Xos, Urb, Urb, Urb, Urb, Urb, Xos, Xos
Xos, Xos, Xos, Rr, Rr, Rr, Rr, Rr, Xos, Xos, Urb, Xos, Xos, Rr, Rr, Rr, Rr, Xol^Ii, Xos, Urb, Xos, Xos, Xos, Xos
Xos, Xos, Xos, Xos, Xos, Rr, Xos, Xos, Urb, Urb, Urb, Urb, Urb, Xos, Xos, Rr, Rr, Rr, Rr, Xos, Xos, Xos, Rr^Tshy, Xos
Xos, Xos, Xos, Xos, Xos, Xos, Urb, Urb, Urb, Urb, Urb, Urb, Xos, Xos, Rr, Rr, Rr, Rr, Xos, Rr^Gye, Rr^Tshy, Rr^Tshy, Rr^Tshy, Xos
Xos, Xos, Rr, Xos, Xos, Urb, Urb, Urb, Urb, Urb, Xos, Xos, Rr, Rr, Rr, Rr, Xos, Xos, Rr^Tshy, Rr^Tshy, Rr^Tshy, Rr^Tshy, Rr^Tshy, Xos
Xos, Rr, Rr^Bryu, Rr, Xos, Urb, Urb, Urb, Xos, Xos, Rr, Rr, Rr, Rr, Xos, Xos, Xos, Xos, Xos, Rr^Tshy, Rr^Tshy, Rr^Tshy, Xos, Xos
Xos, Rr, Rr, Rr, Xos, Xos, Xos, Xos, Rr, Rr, Rr, Rr, Xos, Xos, Xos, Xos, Xos, Xos, Xos, Xos, Xos, Xos, Xos, Xos
Xos, Xos, Rr, Xos, Xos, Xos, Rr, Rr, Rr, Rr, Rr, Rr, Rr, Xos, Xos, Xos, Xos, Xos, Xos, Xos, Xos, Xos, Xos, Xos
Xos, Xos, Xos, Rr, Rr, Rr, Rr, Rr, Xos, Xos, Xos, Rr, Rr, Rr, Rr, Xos, Xos, Xos, Xos, Xos, Xos, Xos, Xos, Xos
Xos, Xos, Rr, Rr, Rr, Rr, Xos, Xos, Xos, Xos, Xos, Xos, Xos, Rr, Rr, Rr, Rr, Xos, Xos, Xos, Xos, Xos, Xos, Xos
Xos, Xos, Xos, Rr, Xos, Xos, Xos, Xos, Xos, Xos, Xos, Xos, Xos, Xos, Xos, Rr, 1 Rr, Rr, Xos, Xos, Xos, Xos, Xos, Xos
Xos, Xos, Xos, Xos, Xos, Xos, Xos, Xos, Xos, Xos, Xos, Xos, Xos, Xos, Xos, Rr, Rr, Rr, Xos, Xos, Xos, Xos, Xos, Xos
Xos, Xos, Xos, Xos, Xos, Xos, Xos, Xos, Xos, Xos, Xos, Xos, Xos, Xos, Xos, Rr, 3 Rr, Rr, Xos, Xos, Xos, Xos, Xos, Xos
Xos, Xos, Xos, Xos, Xos, Xos, Xos, Xos, Xos, Xos, Xos, Xos, Xos, Xos, Xos, Rr, Rr, Rr, Xos, Xos, Xos, Xos, Xos, Xos
