border_size=1
usage=map

Xos, Xos, Xos, Xos, Xos, Xos, Xos, Qxua, Qxua, Qxua, Qxua, Qxua, Qxua, Qxua, Qxua, Qxua, Xos, Xos, Xos, Xos, Rr, Rr, Rr, Rr, Rr, Xos, Xos, Xos, Xos, Xos, Xos, Xos, Xos, Xos, Xos, Xos, Xos, Xos, Xos, Xos, Xos, Xos, Xos, Xos, Xos, Xos
Xos, Xos, Xos, Xos, Xos, Xos, Qxua, Qxua, Qxua, Qxua, Qxua, Qxua, Qxua, Qxua, Qxua, Qxua, Qxua, Xos, Xos, Xos, Xos, Rr, Rr, Rr, Xos, Xos, Qxua, Xos, Qxua, Qxua, Qxua, Qxua, Qxua, Qxua, Qxua, Qxua, Qxua, Xos, Xos, Xos, Xos, Xos, Xos, Xos, Xos, Xos
Xos, Xos, Xos, Xos, Qxua, Qxua, Qxua, Qxua, Qxua, Qxua, Qxua, Qxua, Qxua, Qxua, Fypd, Qxua, Qxua, Qxua, Qxua, Xos, Uu, Rr, Ur, Rr, Uu, Xos, Qxua, Qxua, Qxua, Qxua, Qxua, Qxua, Qxua, Qxua, Qxua, Qxua, Qxua, Qxua, Qxua, Xos, Xos, Xos, Xos, Xos, Xos, Xos
Xos, Xos, Qxua, Qxua, Qxua, Qxua, Qxua, Qxua, Qxua, Qxua, Qxua, Qxua, Fypd, Fypd, Fypd^Ayb, Fypd, Fypd, Qxua, Qxua, Uh, Uu, Ur, Ur, Ur, Uh, Qxua, Qxua, Qxua, Qxua, Qxua, Fypd, Fypd, Fypd, Qxua, Qxua, Qxua, Qxua, Qxua, Qxua, Qxua, Qxua, Xos, Xos, Xos, Xos, Xos
Xos, Xos, Qxua, Qxua, Qxua, Qxua, Qxua, Qxua, Qxua, Qxua, Qxua, Qxua, Fypd, Fypd, Fypd, Fypd, Fypd, Fypd, Qxua, Qxua, Qxua, Ur, Ur, Ur, Qxu^Bcx\, Qxua, Qxua, Qxua, Qxua, Qxua, Qxua, Fypd, Fypd, Fypd, Qxua, Qxua, Qxua, Qxua, Qxua, Qxua, Qxua, Qxua, Qxua, Xos, Xos, Xos
Xos, Qxua, Qxua, Qxua, Qxua, Qxua, Qxua, Qxua, Qxua, Qxua, Fypd, Fypd, Fypd, Fypd, Qxua, Fypd, Qxu^Bcx\, Qxua, Qxua, Qxua, Qxua, Qxua, Qxua, Qxua, Qxua, Qxu^Bcx\, Fypd, Fypd, Fypd, Qxua, Qxua, Qxua, Qxua, Qxua, Qxua, Qxua, Qxua, Qxua, Fypd, Qxua, Qxua, Qxua, Qxua, Qxua, Xos, Xos
Xos, Qxua, Qxua, Qxua, Qxua, Qxua, Qxua, Qxua, Fypd, Fypd, Fypd, Fypd, Qxua, Qxua, Qxua, Qxua, Qxua, Qxu^Bcx\, Fypd, Fypd, Fypd, Qxua, Qxua, Qxua, Qxua, Fypd, Fypd, Fypd, Fypd, Fypd, Fypd, Qxua, Qxua, Qxua, Qxua, Qxua, Fypd, Fypd, Wwt, Fypd, Fypd, Qxua, Qxua, Qxua, Xos, Xos
Xos, Qxua, Qxua, Qxua, Qxua, Qxua, Qxua, Qxua, Qxua, Fypd, Qxua, Qxua, Qxua, Qxua, Fypd, Qxua, Qxua, Fypd, Fypd, Fypd, Fypd, Fypd, Fypd, Qxua, Qxua, Qxua, Qxua, Fypd, Fypd, Fypd, Fypd, Fypd, Qxua, Qxua, Qxua, Fypd, Fypd, Wwt, Wwt, Wwt, Fypd^Ayb, Fypd, Fypd, Qxua, Xos, Xos
Xos, Qxua, Qxua, Qxua, Qxua, Qxua, Fypd, Qxua, Qxua, Qxua, Qxua, Qxua, Fypd, Fypd, Qxua, Qxua, Fypd, Fypd, Fypd, Fypd, Fypd, Fypd, Fypd, Fypd, Qxua, Qxua, Qxua, Qxua, Qxua, Fypd, Qxua, Qxua, Qxua, Qxua, Qxua, Qxua, Qxua, Fypd, Fypd, Fypd, Fypd, Fypd, Qxua, Qxua, Xos, Xos
Xos, Qxua, Qxua, Qxua, Fypd, Fypd, Qlf, Fypd, Fypd, Qxua, Fypd, Qxua, Qxua, Qxua, Qxua, Qxua, Qxua, Fypd, Fypd, Fypd, Fypd, Fypd, Qxua, Qxua, Qxua, Qxua, Qxua, Qxua, Qxua, Qxua, Qxua, Qxua, Qxua, Qxua, Fypd, Fypd, Fypd, Qxua, Qxua, Qxua, Qxua, Qxua, Qxua, Qxua, Xos, Xos
Xos, Qxua, Qxua, Qxua, Qxua, Fypd, Fypd, Fypd, Fypd, Fypd, Qxu^Bcx\, Qxua, Qxua, Qxua, Fypd, Qxua, Qxua, Qxua, Qxua, Fypd, Qxua, Qxu^Bcx\, Qxu^Bcx\, Qxua, Fypd, Fypd, Fypd, Qxua, Qxua, Qxua, Qxua, Qxua, Qxua, Fypd, Fypd, Fypd, Fypd, Fypd, Fypd, Qxua, Qxua, Qxua, Qxua, Qxua, Xos, Xos
Xos, Qxua, Qxua, Qxua, Qxua, Qxua, Qxua, Fypd, Qxua, Qxua, Qxua, Qxu^Bcx\, Fypd, Fypd, Fypd, Fypd, Fypd, Qxua, Qxua, Qxua, Qxua, Qxua, Fypd, Fypd, Fypd, Qlf, Fypd, Fypd, Qxua, Qxua, Qxua, Qxua, Qxua, Qxua, Qxua, Fypd, Fypd, Fypd, Qxua, Qxua, Qxua, Qxua, Qxua, Qxua, Xos, Xos
Xos, Qxua, Qxua, Qxua, Qxua, Qxua, Qxua, Qxua, Qxua, Qxua, Qxua, Fypd, Fypd, Fypd, Fypd, Fypd, Fypd, Fypd, Fypd, Qxua, Qxua, Qxua, Qxua, Fypd, Fypd, Fypd, Qxua, Qxua, Qxua, Qxua, Qxua, Qxua, Qxua, Qxua, Fypd, Fypd, Qxua, Qxua, Qxua, Qxua, Qxua, Qxua, Qxua, Qxua, Xos, Xos
Xos, Qxua, Qxua, Qxua, Fypd, Fypd, Fypd, Qxua, Qxua, Qxua, Qxua, Qxua, Qxua, Fypd, Fypd, Fypd, Fypd, Fypd, Qxua, Qxua, Qxua, Qxua, Qxua, Qxua, Qxua, Qxua, Qxua, Qxua, Qxua, Qxua, Qxua, Qxua, Fypd, Fypd, Qxua, Qxua, Qxua, Qxua, Qxua, Qxua, Qxua, Qxua, Qxua, Qxua, Xos, Xos
Xos, Qxua, Qxua, Qxua, Qxua, Fypd, Qxua, Qxua, Qxua, Qxua, Fypd, Qxua, Qxua, Qxua, Qxua, Fypd, Qxua, Qxu^Bcx\, Fypd, Fypd, Qxua, Qxua, Qxua, Qxua, Qxua, Qxua, Qxua, Qxua, Qxua, Qxua, Fypd, Fypd, Qxua, Qxua, Qxua, Qxua, Qxua, Qxua, Qxua, Qxua, Qxua, Qxua, Qxua, Qxua, Xos, Xos
Xos, Qxua, Qxua, Qxua, Qxua, Qxua, Qxua, Qxua, Fypd, Fypd, Fypd, Fypd, Qxua, Qxua, Qxua, Qxua, Qxua, Fypd, Qxua, Qxu^Bcx\, Fypd, Fypd, Fypd^Bryl, Qxua, Qxua, Qxua, Qxua, Qxua, Fypd, Fypd, Qxu^Bcx\, Qxua, Qxua, Qxua, Fypd, Fypd, Fypd, Qxua, Qxua, Qxua, Qxua, Qxua, Qxua, Qxua, Xos, Xos
Xos, Qxua, Qxua, Qxua, Qxua, Qxua, Fypd, Fypd, Fypd, Fypd, Fypd, Qxua, Qxua, Fypd, Fypd, Qxua, Qxua, Qxua, Fypd, Fypd, Fypd, Fypd, Fypd, Fypd, Fypd, Qxua, Fypd, Fypd, Qxua, Qxua, Qxua, Qxu^Bcx\, Fypd, Fypd, Fypd, Qlf, Fypd, Fypd, Fypd, Qxua, Qxua, Qxua, Qxua, Qxua, Xos, Xos
Xos, Qxua, Qxua, Qxua, Fypd, Fypd, Fypd, Fypd, Fypd, Fypd, Fypd, Fypd, Fypd, Qxua, Qxua, Fypd, Qxua, Qxua, Qxua, Fypd^Bryl, Fypd, Fypd, Fypd, Fypd, Fypd, Fypd, Qxua, Qxua, Qxua, Qxua, Fypd, Fypd, Fypd, Fypd, Fypd, Fypd, Fypd, Fypd, Fypd, Fypd, Fypd, Qxua, Qxua, Qxua, Xos, Xos
Xos, Xos, Xos, Fypd, Fypd, Fypd, Fypd, Fypd, Fypd, Fypd, Fypd, Fypd, Fypd, Fypd, Fypd, Qxua, Qxua, Qxua, Qxua, Qxua, Qxua, Fypd, Fypd, Fypd, Fypd, Qxua, Qxua, Qxua, Qxua, Fypd, Fypd, Qlf, Fypd, Fypd, Fypd, Fypd, Fypd, Fypd, Fypd, Qlf, Fypd, Qxua, Qxua, Qxua, Xos, Xos
Xos, Xos, Xos, Xos, Xos, Fypd, Fypd, Fypd, Fypd, Fypd, Fypd, Fypd, Fypd, Fypd, Xos, Qxua, Qxua, Qxua, Fypd, Qxua, Qxua, Qxua, Qxua, Fypd, Fypd, Fypd, Fypd, Qxua, Qxua, Qxua, Qxua, Fypd, Fypd, Fypd, Fypd, Fypd, Fypd, Fypd, Fypd, Fypd, Qxua, Qxua, Qxua, Qxua, Xos, Xos
Xos, Xos, Xos, Xos, Xos, Uu, Uu, Fypd, Fypd, Fypd, Fypd, Fypd, Uu, Uu, Xos, Qxua, Qxua, Fypd, Fypd, Fypd, Qxua, Qxua, Qxua, Qxua, Qxua, Fypd, Fypd, Fypd, Fypd, Qxua, Qxua, Qxua, Qxua, Fypd, Fypd, Qlf, Fypd, Fypd, Qxua, Qxua, Qxua, Qxua, Qxua, Qxua, Xos, Xos
Xos, Xos, Xos, Xos, Xos, Uu, Uu, Uu, Rr, Rr^Ecf, Rr, Uu, Uu, Xos, Qxua, Qxua, Qxua, Qxua, Qxua, Qxua, Qxua, Qxua, Qxua, Qxua, Qxua, Qxua, Qxua, Fypd, Fypd, Fypd, Fypd, Qxua, Qxua, Qxua, Qxua, Fypd, Qxua, Qxua, Qxua, Qxua, Fypd, Qxua, Qxua, Qxua, Xos, Xos
Xos, Xos, Xos, Xos, Xos, Uu, Uu^Em, Uu, Rr, Rr, Rr, Uu, Uu, Xos, Qxua, Qxua, Qxua, Qxua, Fypd, Qxua, Qxua, Qxua, Fypd, Fypd, Qxua, Qxua, Qxua, Qxua, Qxua, Fypd, Fypd, Fypd, Fypd, Qxua, Qxua, Qxua, Qxua, Qxua, Fypd, Fypd, Fypd, Fypd, Qxua, Qxua, Xos, Xos
Xos, Xos, Xos, Xos, Xos, Uu, Uu, Uu^Es, Rr, Rr, Rr, Uu^Es, Uu, Xos, Qxua, Qxua, Fypd, Fypd, Fypd, Fypd, Fypd, Fypd, Qxua, Qxua, Qxua, Qxua, Qxua, Qxua, Qxua, Qxua, Qxua, Fypd, Qxu^Bcx\, Qxua, Fypd, Qxua, Qxua, Qxua, Qxua, Fypd, Qxua, Qxua, Qxua, Qxua, Xos, Xos
Xos, Xos, Xos, Xos, Xos, Xos, Uu, Uu, Rr, Rr, Rr, Uu, Xos, Xos, Qxua, Qxua, Qxua, Fypd, Fypd, Qlf, Fypd, Fypd, Qxua, Qxua, Qxua, Qxua, Qxua, Qxua, Qxua, Qxua, Qxua, Qxua, Fypd, Fypd, Fypd, Fypd, Fypd, Qxua, Qxua, Qxua, Qxua, Qxua, Qxua, Qxua, Xos, Xos
Xos, Xos, Xos, Xos, Xos, Xos, Xos, Uu, Rr, Rr, Rr, Uu, Xos, Qxua, Qxua, Qxua, Qxua, Qxua, Qxua, Fypd, Qxua, Qxua, Qxua, Qxua, Qxua, Qxua, Qxua, Qxua, Qxua, Qxua, Qxua, Qxua, Qxua, Fypd, Fypd, Fypd, Qxua, Qxua, Qxua, Qxua, Qxua, Qxua, Qxua, Qxua, Xos, Xos
Xos, Xos, Xos, Xos, Xos, Xos, Xos, Uu, Rr, Rr, Rr, Uu, Xos, Qxua, Qxua, Qxua, Qxua, Qxua, Qxua, Qxua, Qxua, Qxua, Qxua, Qxua, Qxua, Qxua, Fypd, Qxua, Qxua, Qxua, Fypd, Fypd, Fypd, Qxua, Qxua, Qxua, Fypd, Fypd, Fypd, Qxua, Qxua, Qxua, Qxua, Qxua, Xos, Xos
Xos, Xos, Xos, Xos, Xos, Xos, Xos, Xos, Rr, Rr, Rr, Uu, Xos, Qxua, Qxua, Qxua, Qxua, Qxua, Qxua, Qxua, Qxua, Qxua, Qxua, Qxua, Fypd, Fypd, Fypd, Fypd, Fypd, Fypd, Fypd, Fypd, Qxua, Qxua, Qxua, Qxua, Qxua, Fypd, Qxua, Qxua, Qxua, Qxua, Qxua, Qxua, Xos, Xos
Xos, Xos, Xos, Xos, Xos, Xos, Xos, Xos, Rr, Rr, Rr, Xos, Qxua, Qxua, Qxua, Qxua, Qxua, Qxua, Qxua, Qxua, Qxua, Qxua, Qxua, Fypd^Bryl, Fypd, Fypd, Fypd, Fypd, Fypd, Fypd, Qxua, Qxua, Qxua, Qxua, Fypd, Qxua, Qxua, Qxua, Qxua, Qxua, Qxua, Qxua, Qxua, Qxua, Xos, Xos
Xos, Xos, Xos, Xos, Xos, Xos, Xos, Xos, Rr, Rr, Rr, Xos, Qxua, Qxua, Qxua, Qxua, Qxua, Qxua, Qxua, Qxua, Qxua, Qxua, Qxua, Qxua, Qxua, Fypd, Fypd^Bryl, Fypd, Qxua, Qxua, Qxua, Qxua, Qxua, Fypd, Fypd, Fypd, Qxua, Qxua, Qxua, Qxua, Qxua, Qxua, Qxua, Qxua, Xos, Xos
Xos, Xos, Xos, Xos, Xos, Xos, Xos, Xos, Rr, Rr, Rr, Xos, Xos, Qxua, Qxua, Qxua, Qxua, Qxua, Qxua, Qxua, Qxua, Qxua, Qxua, Qxua, Qxua, Qxua, Qxua, Qxua, Qxua, Qxua, Qxua, Qxua, Qxua, Qxua, Qxua, Qxua, Qxua, Qxua, Qxua, Qxua, Qxua, Qxua, Xos, Xos, Xos, Xos
Xos, Xos, Xos, Xos, Xos, Xos, Xos, Xos, Rr, Rr, Rr, Xos, Xos, Qxua, Qxua, Qxua, Qxua, Qxua, Qxua, Qxua, Xos, Qxua, Qxua, Qxua, Qxua, Qxua, Qxua, Qxua, Qxua, Qxua, Qxua, Qxua, Qxua, Qxua, Qxua, Qxua, Qxua, Qxua, Qxua, Qxua, Xos, Xos, Xos, Xos, Xos, Xos
Xos, Xos, Xos, Xos, Xos, Xos, Xos, Xos, Rr, Rr, Rr, Xos, Xos, Qxua, Qxua, Qxua, Qxua, Qxua, Xos, Xos, Xos, Qxua, Qxua, Qxua, Qxua, Qxua, Qxua, Qxua, Qxua, Qxua, Qxua, Qxua, Qxua, Qxua, Qxua, Qxua, Qxua, Qxua, Xos, Xos, Xos, Xos, Xos, Xos, Xos, Xos
Xos, Xos, Xos, Xos, Xos, Xos, Xos, Xos, Rr, Rr, Rr, Xos, Xos, Xos, Xos, Qxua, Xos, Xos, Xos, Xos, Xos, Qxua, Xos, Qxua, Xos, Qxua, Xos, Qxua, Xos, Qxua, Xos, Xos, Xos, Qxua, Xos, Qxua, Xos, Xos, Xos, Xos, Xos, Xos, Xos, Xos, Xos, Xos
Xos, Xos, Xos, Xos, Xos, Xos, Xos, Xos, Rr, Rr, Rr, Xos, Xos, Xos, Xos, Xos, Xos, Xos, Xos, Xos, Xos, Xos, Xos, Xos, Xos, Xos, Xos, Xos, Xos, Xos, Xos, Xos, Xos, Xos, Xos, Xos, Xos, Xos, Xos, Xos, Xos, Xos, Xos, Xos, Xos, Xos
